profile_time,exec_time,algorithm,program,strategy,run,total_time,RC
62536,3112018,gp,codec,GI,1,3174554,0.6966581168671568
65143,4033459,gp,codec,GI,2,4098602,0.8994411029416928
64352,3749758,gp,codec,GI,3,3814110,0.8370091326605853
63597,4095628,gp,codec,GI,4,4159225,0.9127448630978715
66969,4581268,gp,codec,GI,5,4648237,1.0200588917914901
64278,12785098,gp,codec,GI,6,12849376,2.8198046362033975
64519,4610630,gp,codec,GI,7,4675149,1.025964749194177
66217,4758918,gp,codec,GI,8,4825135,1.0588792827999804
67003,3169107,gp,codec,GI,9,3236110,0.7101666245321311
66244,4792395,gp,codec,GI,10,4858639,1.0662317592573085
66254,3850443,gp,codec,GI,11,3916697,0.859521922247737
64750,3204060,gp,codec,GI,12,3268810,0.7173426626217513
63125,3393798,gp,codec,GI,13,3456923,0.7586241932992044
65613,4665934,gp,codec,GI,14,4731547,1.0383413301170639
64961,4400466,gp,codec,GI,15,4465427,0.9799411082085098
63956,4892689,gp,codec,GI,16,4956645,1.0877392451597951
65609,6192659,gp,codec,GI,17,6258268,1.3733813315917724
64486,4854428,gp,codec,GI,18,4918914,1.0794591505677629
63428,30757491,gp,codec,GI,19,30820919,6.763672437342434
63718,3429746,gp,codec,GI,20,3493464,0.7666431415509722
75751,1215624,gp,codec,GI+Ekstazi,1,1291375,0.28339315559581746
75070,2739375,gp,codec,GI+Ekstazi,2,2814445,0.6176319425425383
74448,1612734,gp,codec,GI+Ekstazi,3,1687182,0.37025328122695766
71543,1379821,gp,codec,GI+Ekstazi,4,1451364,0.318502854614785
75717,2601186,gp,codec,GI+Ekstazi,5,2676903,0.5874482535235005
71191,7322156,gp,codec,GI+Ekstazi,6,7393347,1.6224752196262666
72437,1762378,gp,codec,GI+Ekstazi,7,1834815,0.4026514473212969
70378,1661260,gp,codec,GI+Ekstazi,8,1731638,0.3800091818175434
71247,1694213,gp,codec,GI+Ekstazi,9,1765460,0.38743144359941295
72746,2239991,gp,codec,GI+Ekstazi,10,2312737,0.5075317676842157
75241,1715180,gp,codec,GI+Ekstazi,11,1790421,0.39290915267448967
74882,2639036,gp,codec,GI+Ekstazi,12,2713918,0.595571221409962
72432,1698708,gp,codec,GI+Ekstazi,13,1771140,0.388677923610087
71311,1448479,gp,codec,GI+Ekstazi,14,1519790,0.33351898863069784
71070,2824748,gp,codec,GI+Ekstazi,15,2895818,0.6354893048503872
72720,1710428,gp,codec,GI+Ekstazi,16,1783148,0.3913130876889909
69467,1826670,gp,codec,GI+Ekstazi,17,1896137,0.4161086035210427
69984,1709578,gp,codec,GI+Ekstazi,18,1779562,0.3905261374568999
70990,2071275,gp,codec,GI+Ekstazi,19,2142265,0.4701215669131537
70943,1263121,gp,codec,GI+Ekstazi,20,1334064,0.2927612867887164
105218,1874207,gp,codec,GI+STARTS,1,1979425,0.43438621393108195
105667,1449665,gp,codec,GI+STARTS,2,1555332,0.34131870562706723
108430,1677632,gp,codec,GI+STARTS,3,1786062,0.3919525670465797
110585,1210925,gp,codec,GI+STARTS,4,1321510,0.29000630262427934
110771,1798885,gp,codec,GI+STARTS,5,1909656,0.41907535761687065
106272,2083211,gp,codec,GI+STARTS,6,2189483,0.48048359035400035
112767,1918840,gp,codec,GI+STARTS,7,2031607,0.44583759067703177
106865,2270916,gp,codec,GI+STARTS,8,2377781,0.5218057194120828
108381,1338681,gp,codec,GI+STARTS,9,1447062,0.31755877767712304
105755,1883470,gp,codec,GI+STARTS,10,1989225,0.43653683085090694
105053,1230637,gp,codec,GI+STARTS,11,1335690,0.2931181136368424
110237,6154120,gp,codec,GI+STARTS,12,6264357,1.3747175669412435
109451,1166419,gp,codec,GI+STARTS,13,1275870,0.2799905723976657
106533,1423144,gp,codec,GI+STARTS,14,1529677,0.3356886977619539
104351,3932706,gp,codec,GI+STARTS,15,4037057,0.8859350092344858
104660,1400642,gp,codec,GI+STARTS,16,1505302,0.3303395868006545
105159,1753902,gp,codec,GI+STARTS,17,1859061,0.4079722491415088
106563,1543032,gp,codec,GI+STARTS,18,1649595,0.36200478753660437
109760,8704883,gp,codec,GI+STARTS,19,8814643,1.9343796304098988
104212,1169876,gp,codec,GI+STARTS,20,1274088,0.27959951123938737
67176,2503160,gp,codec,GI+Random,1,2570336,0.5640620501260525
62780,3559766,gp,codec,GI+Random,2,3622546,0.7949702775963652
64896,3192847,gp,codec,GI+Random,3,3257743,0.7149140016572917
65177,2836989,gp,codec,GI+Random,4,2902166,0.6368823779327393
64670,3697162,gp,codec,GI+Random,5,3761832,0.8255366886468494
63089,4529427,gp,codec,GI+Random,6,4592516,1.0078308789966364
63017,3512535,gp,codec,GI+Random,7,3575552,0.784657411113686
65529,3212299,gp,codec,GI+Random,8,3277828,0.7193216690894024
64817,3100310,gp,codec,GI+Random,9,3165127,0.6945893550607088
61526,3413678,gp,codec,GI+Random,10,3475204,0.7626359716575024
61519,3455524,gp,codec,GI+Random,11,3517043,0.7718175697502124
63128,2597721,gp,codec,GI+Random,12,2660849,0.5839251918876974
60286,3097252,gp,codec,GI+Random,13,3157538,0.6929239436520811
60575,3552770,gp,codec,GI+Random,14,3613345,0.7929511116494968
63325,4789658,gp,codec,GI+Random,15,4852983,1.0649905460635811
62260,3567177,gp,codec,GI+Random,16,3629437,0.796482512412132
64504,3445707,gp,codec,GI+Random,17,3510211,0.7703182825261059
62958,3552634,gp,codec,GI+Random,18,3615592,0.7934442173861138
60914,12485045,gp,codec,GI+Random,19,12545959,2.7532195613092605
61446,2775297,gp,codec,GI+Random,20,2836743,0.6225252543872585
184049,9738080,gp,compress,GI,1,9922129,1.2710808588177653
182684,8870700,gp,compress,GI,2,9053384,1.1597897094390746
183817,5807883,gp,compress,GI,3,5991700,0.7675706677244778
182434,6981043,gp,compress,GI,4,7163477,0.9176819306906119
182364,5563354,gp,compress,GI,5,5745718,0.736058981894379
180698,5614189,gp,compress,GI,6,5794887,0.7423578089653847
179352,7666183,gp,compress,GI,7,7845535,1.0050574191975168
176950,8263515,gp,compress,GI,8,8440465,1.0812713179823896
180906,5787945,gp,compress,GI,9,5968851,0.764643581557474
180588,11074745,gp,compress,GI,10,11255333,1.4418718337485772
181119,5631592,gp,compress,GI,11,5812711,0.744641164203718
171174,9573243,gp,compress,GI,12,9744417,1.2483149462215652
178701,8255275,gp,compress,GI,13,8433976,1.0804400403712169
170429,7457082,gp,compress,GI,14,7627511,0.9771273113383179
179119,12883277,gp,compress,GI,15,13062396,1.6733668274115105
181002,10424763,gp,compress,GI,16,10605765,1.3586584980521215
178822,7587756,gp,compress,GI,17,7766578,0.9949425808024833
178288,4626774,gp,compress,GI,18,4805062,0.6155556265830257
179031,5305283,gp,compress,GI,19,5484314,0.7025716506151345
181008,9815794,gp,compress,GI,20,9996802,1.2806468925762964
224239,2841411,gp,compress,GI+Ekstazi,1,3065650,0.3927271087520312
227495,3000252,gp,compress,GI+Ekstazi,2,3227747,0.41349265150719827
224120,2413857,gp,compress,GI+Ekstazi,3,2637977,0.3379397779147512
223515,2218938,gp,compress,GI+Ekstazi,4,2442453,0.3128920473481072
225555,2581103,gp,compress,GI+Ekstazi,5,2806658,0.35954876831854854
226036,2304109,gp,compress,GI+Ekstazi,6,2530145,0.3241258886609391
225271,1915838,gp,compress,GI+Ekstazi,7,2141109,0.27428817611043427
224479,2339344,gp,compress,GI+Ekstazi,8,2563823,0.3284402309924352
225376,2552843,gp,compress,GI+Ekstazi,9,2778219,0.3559055715264167
225255,5617248,gp,compress,GI+Ekstazi,10,5842503,0.7484576879503755
224367,1967017,gp,compress,GI+Ekstazi,11,2191384,0.2807286880385762
225629,2199296,gp,compress,GI+Ekstazi,12,2424925,0.31064661138437827
224191,3049269,gp,compress,GI+Ekstazi,13,3273460,0.4193487454260676
225123,2013509,gp,compress,GI+Ekstazi,14,2238632,0.28678142414162644
225305,3000416,gp,compress,GI+Ekstazi,15,3225721,0.4132331094452109
222760,1901818,gp,compress,GI+Ekstazi,16,2124578,0.2721704614871799
224293,2250260,gp,compress,GI+Ekstazi,17,2474553,0.3170042389521521
223203,1535619,gp,compress,GI+Ekstazi,18,1758822,0.22531504864203838
224545,1990852,gp,compress,GI+Ekstazi,19,2215397,0.2838048891908482
223673,2239392,gp,compress,GI+Ekstazi,20,2463065,0.3155325611594023
294651,3175958,gp,compress,GI+STARTS,1,3470609,0.4446046476860627
299337,3295562,gp,compress,GI+STARTS,2,3594899,0.4605268998501356
298118,2524962,gp,compress,GI+STARTS,3,2823080,0.36165251942514126
299192,2349002,gp,compress,GI+STARTS,4,2648194,0.339248633416886
300196,2170941,gp,compress,GI+STARTS,5,2471137,0.3165666300263135
298494,2720652,gp,compress,GI+STARTS,6,3019146,0.38676968325812144
295288,3398138,gp,compress,GI+STARTS,7,3693426,0.4731487659614045
290633,3144142,gp,compress,GI+STARTS,8,3434775,0.4400141095571112
296119,3203958,gp,compress,GI+STARTS,9,3500077,0.44837966519970746
303428,3077241,gp,compress,GI+STARTS,10,3380669,0.43308282485529026
307606,2333304,gp,compress,GI+STARTS,11,2640910,0.3383155118080429
306447,2767939,gp,compress,GI+STARTS,12,3074386,0.39384623977548716
306927,3561152,gp,compress,GI+STARTS,13,3868079,0.4955228033514746
303106,2611964,gp,compress,GI+STARTS,14,2915070,0.37343695885367983
300813,2221981,gp,compress,GI+STARTS,15,2522794,0.3231841839730471
289762,6392556,gp,compress,GI+STARTS,16,6682318,0.856042740659128
299046,1988906,gp,compress,GI+STARTS,17,2287952,0.29309959516690665
292858,1815506,gp,compress,GI+STARTS,18,2108364,0.2700933563573361
297796,1780534,gp,compress,GI+STARTS,19,2078330,0.2662458310415765
282629,2297350,gp,compress,GI+STARTS,20,2579979,0.330509905994147
220411,6340022,gp,compress,GI+Random,1,6560433,0.8404285826012149
183305,8207723,gp,compress,GI+Random,2,8391028,1.0749381585951883
181687,6684910,gp,compress,GI+Random,3,6866597,0.8796499231077818
178991,6861568,gp,compress,GI+Random,4,7040559,0.9019354394885561
181216,6782408,gp,compress,GI+Random,5,6963624,0.8920796307328803
181749,24407538,gp,compress,GI+Random,6,24589287,3.150026777285048
181162,7476853,gp,compress,GI+Random,7,7658015,0.9810350463130776
185378,6494653,gp,compress,GI+Random,8,6680031,0.855749763020547
173830,7165596,gp,compress,GI+Random,9,7339426,0.9402219930127331
186105,9193185,gp,compress,GI+Random,10,9379290,1.2015401118349578
181309,5143087,gp,compress,GI+Random,11,5324396,0.6820852500875442
185171,9513373,gp,compress,GI+Random,12,9698544,1.2424383553975045
187350,11018555,gp,compress,GI+Random,13,11205905,1.4355398273122928
179888,6526175,gp,compress,GI+Random,14,6706063,0.8590846094952042
185619,7272373,gp,compress,GI+Random,15,7457992,0.9554109683935801
189899,6606312,gp,compress,GI+Random,16,6796211,0.8706330783027256
190014,6272298,gp,compress,GI+Random,17,6462312,0.8278587273868694
190624,5278549,gp,compress,GI+Random,18,5469173,0.7006320028557314
190016,4563050,gp,compress,GI+Random,19,4753066,0.6088946448184176
189742,5452380,gp,compress,GI+Random,20,5642122,0.722787748205512
23997,4225380,gp,csv,GI,1,4249377,1.024544203870307
19268,5819141,gp,csv,GI,2,5838409,1.4076670770266406
19352,4071602,gp,csv,GI,3,4090954,0.986347694968003
19186,3974424,gp,csv,GI,4,3993610,0.9628776119460563
19261,5415915,gp,csv,GI,5,5435176,1.3104457589465466
18898,3411156,gp,csv,GI,6,3430054,0.8270016862853453
19973,4143412,gp,csv,GI,7,4163385,1.0038111398989964
19983,3240226,gp,csv,GI,8,3260209,0.7860512810126777
19102,6414146,gp,csv,GI,9,6433248,1.551085476873491
19237,4424621,gp,csv,GI,10,4443858,1.0714344612687212
19398,5155505,gp,csv,GI,11,5174903,1.2476927498409915
19301,3643106,gp,csv,GI,12,3662407,0.8830230558653749
19405,3481109,gp,csv,GI,13,3500514,0.8439899141137309
19286,3859504,gp,csv,GI,14,3878790,0.9351939855019001
19657,5502169,gp,csv,GI,15,5521826,1.331337469723294
19394,8346733,gp,csv,GI,16,8366127,2.017111432262395
19624,3835485,gp,csv,GI,17,3855109,0.9294843882381476
19335,3726046,gp,csv,GI,18,3745381,0.9030284662518704
19178,4112593,gp,csv,GI,19,4131771,0.9961888601010035
19261,5838460,gp,csv,GI,20,5857721,1.4123232884348407
25494,3914514,gp,csv,GI+Ekstazi,1,3940008,0.9499539249171444
25404,4362911,gp,csv,GI+Ekstazi,2,4388315,1.0580427902742275
25418,3945792,gp,csv,GI+Ekstazi,3,3971210,0.9574768696333137
25555,4886457,gp,csv,GI+Ekstazi,4,4912012,1.1843085289776347
25696,4143068,gp,csv,GI+Ekstazi,5,4168764,1.0051080413677573
25253,4206049,gp,csv,GI+Ekstazi,6,4231302,1.0201862388121452
25320,3735278,gp,csv,GI+Ekstazi,7,3760598,0.9066973544560223
24997,3693123,gp,csv,GI+Ekstazi,8,3718120,0.8964557146363492
25111,3062623,gp,csv,GI+Ekstazi,9,3087734,0.744466770727398
25521,5266603,gp,csv,GI+Ekstazi,10,5292124,1.2759552683517947
25050,4400401,gp,csv,GI+Ekstazi,11,4425451,1.0669964494941384
25769,4260362,gp,csv,GI+Ekstazi,12,4286131,1.0334057611454204
25594,3240002,gp,csv,GI+Ekstazi,13,3265596,0.7873501113179788
25546,4027926,gp,csv,GI+Ekstazi,14,4053472,0.9773106135677255
25515,4470053,gp,csv,GI+Ekstazi,15,4495568,1.0839019784558603
24849,7512324,gp,csv,GI+Ekstazi,16,7537173,1.8172468365875216
25489,7464854,gp,csv,GI+Ekstazi,17,7490343,1.8059559096899442
25390,3886439,gp,csv,GI+Ekstazi,18,3911829,0.9431598393086278
25345,5629043,gp,csv,GI+Ekstazi,19,5654388,1.3632987734046231
25764,5178411,gp,csv,GI+Ekstazi,20,5204175,1.254750362741822
37338,3962350,gp,csv,GI+STARTS,1,3999688,0.9643430455075227
38446,4172828,gp,csv,GI+STARTS,2,4211274,1.0153573965335914
38001,3975285,gp,csv,GI+STARTS,3,4013286,0.9676215854168384
38326,3537375,gp,csv,GI+STARTS,4,3575701,0.8621178432328458
38617,5838500,gp,csv,GI+STARTS,5,5877117,1.4169997526267137
37793,3475909,gp,csv,GI+STARTS,6,3513702,0.8471696011503581
40549,4042627,gp,csv,GI+STARTS,7,4083176,0.9844723836417302
38952,3779725,gp,csv,GI+STARTS,8,3818677,0.92070046663378
39855,2843932,gp,csv,GI+STARTS,9,2883787,0.695294217492715
39418,3850770,gp,csv,GI+STARTS,10,3890188,0.937942095362643
39365,5461503,gp,csv,GI+STARTS,11,5500868,1.3262844001969343
38724,3813411,gp,csv,GI+STARTS,12,3852135,0.9287673432543041
40060,3537059,gp,csv,GI+STARTS,13,3577119,0.8624597295096078
37389,4103922,gp,csv,GI+STARTS,14,4141311,0.9984889976752698
35644,3778273,gp,csv,GI+STARTS,15,3813917,0.9195528088923223
37181,4090436,gp,csv,GI+STARTS,16,4127617,0.9951873117274709
38127,3616397,gp,csv,GI+STARTS,17,3654524,0.8811224285595111
38705,3690202,gp,csv,GI+STARTS,18,3728907,0.8990565096063293
38990,4066392,gp,csv,GI+STARTS,19,4105382,0.9898263516683713
38022,3790161,gp,csv,GI+STARTS,20,3828183,0.9229924066527501
23280,3304935,gp,csv,GI+Random,1,3328215,0.802447838232337
23784,4875644,gp,csv,GI+Random,2,4899428,1.1812744690997976
22767,3683926,gp,csv,GI+Random,3,3706693,0.8937006127431479
22836,3360406,gp,csv,GI+Random,4,3383242,0.8157150992699836
23209,4471421,gp,csv,GI+Random,5,4494630,1.0836758223715142
23984,3261256,gp,csv,GI+Random,6,3285240,0.7920863694426
22880,3768793,gp,csv,GI+Random,7,3791673,0.9141896788921149
23459,2941670,gp,csv,GI+Random,8,2965129,0.7149061452249964
23025,2450924,gp,csv,GI+Random,9,2473949,0.5964804037440646
23358,3120092,gp,csv,GI+Random,10,3143450,0.7579001528120749
23699,3746923,gp,csv,GI+Random,11,3770622,0.9091141866409745
23344,5886890,gp,csv,GI+Random,12,5910234,1.424984412589709
24525,2571354,gp,csv,GI+Random,13,2595879,0.6258782836633814
23744,3049287,gp,csv,GI+Random,14,3073031,0.7409218102709582
24527,3382424,gp,csv,GI+Random,15,3406951,0.821431447461627
22962,3120754,gp,csv,GI+Random,16,3143716,0.7579642866270387
22950,3993154,gp,csv,GI+Random,17,4016104,0.9683010180881468
23638,4837023,gp,csv,GI+Random,18,4860661,1.17192756833024
22942,5992374,gp,csv,GI+Random,19,6015316,1.4503201627552273
23727,3283903,gp,csv,GI+Random,20,3307630,0.7974847007096671
27216,1841431,gp,fileupload,GI,1,1868647,1.0338447562301742
20267,1804764,gp,fileupload,GI,2,1825031,1.0097138353619015
20201,1524119,gp,fileupload,GI,3,1544320,0.8544081005890266
20252,1724419,gp,fileupload,GI,4,1744671,0.9652539857430829
20308,1650454,gp,fileupload,GI,5,1670762,0.9243632064315189
19752,1744618,gp,fileupload,GI,6,1764370,0.976152624091031
20244,1596460,gp,fileupload,GI,7,1616704,0.8944551607533942
19989,1917999,gp,fileupload,GI,8,1937988,1.0722082509093493
20011,1521415,gp,fileupload,GI,9,1541426,0.8528069706139537
20139,1563377,gp,fileupload,GI,10,1583516,0.8760936190765729
20278,1779825,gp,fileupload,GI,11,1800103,0.99592220854137
20031,2372769,gp,fileupload,GI,12,2392800,1.3238368363353599
20138,1793437,gp,fileupload,GI,13,1813575,1.0033757064764712
20232,1903921,gp,fileupload,GI,14,1924153,1.0645539201542926
20374,1514636,gp,fileupload,GI,15,1535010,0.8492572643527001
20248,1781124,gp,fileupload,GI,16,1801372,0.9966242935235289
20451,1978580,gp,fileupload,GI,17,1999031,1.105980806910862
20396,3020047,gp,fileupload,GI,18,3040443,1.6821508033174484
20115,1909121,gp,fileupload,GI,19,1929236,1.0673661328921282
19941,1959509,gp,fileupload,GI,20,1979450,1.095147453060861
24410,1894073,gp,fileupload,GI+Ekstazi,1,1918483,1.0614169447020938
24705,2028092,gp,fileupload,GI+Ekstazi,2,2052797,1.1357273011194908
24479,2908937,gp,fileupload,GI+Ekstazi,3,2933416,1.6229372104210658
24690,1652082,gp,fileupload,GI+Ekstazi,4,1676772,0.9276882897591583
24512,2187983,gp,fileupload,GI+Ekstazi,5,2212495,1.2240815702138925
24808,1545412,gp,fileupload,GI+Ekstazi,6,1570220,0.8687374946299351
24512,1581895,gp,fileupload,GI+Ekstazi,7,1606407,0.888758258419833
24957,1726025,gp,fileupload,GI+Ekstazi,8,1750982,0.9687455998663328
24899,2845112,gp,fileupload,GI+Ekstazi,9,2870011,1.5878578579436988
25408,1766377,gp,fileupload,GI+Ekstazi,10,1791785,0.99132020469456394
24562,1694118,gp,fileupload,GI+Ekstazi,11,1718680,0.9508742451825711
24764,2071321,gp,fileupload,GI+Ekstazi,12,2096085,1.1596767532138093
24966,1691883,gp,fileupload,GI+Ekstazi,13,1716849,0.9498612289474784
25382,1992140,gp,fileupload,GI+Ekstazi,14,2017522,1.1162111090425393
24970,2222275,gp,fileupload,GI+Ekstazi,15,2247245,1.2433073016008256
24431,3287506,gp,fileupload,GI+Ekstazi,16,3311937,1.8323571548905142
24995,1554952,gp,fileupload,GI+Ekstazi,17,1579947,0.8741190396429048
24710,2326849,gp,fileupload,GI+Ekstazi,18,2351559,1.3010199043028847
25268,1983284,gp,fileupload,GI+Ekstazi,19,2008552,1.111248380681653
24731,2067557,gp,fileupload,GI+Ekstazi,20,2092288,1.1575760308519045
39276,2171704,gp,fileupload,GI+STARTS,1,2210980,1.223243383651268
40637,1440641,gp,fileupload,GI+STARTS,2,1481278,0.8195295809316153
38599,1474646,gp,fileupload,GI+STARTS,3,1513245,0.8372155940322223
40891,1905301,gp,fileupload,GI+STARTS,4,1946192,1.0767471832920372
38647,1760492,gp,fileupload,GI+STARTS,5,1799139,0.9953888673886505
39095,1628822,gp,fileupload,GI+STARTS,6,1667917,0.9227891861208477
39399,1532942,gp,fileupload,GI+STARTS,7,1572341,0.8699109558176095
42124,1736516,gp,fileupload,GI+STARTS,8,1778640,0.98404762227496
39391,1434100,gp,fileupload,GI+STARTS,9,1473491,0.8152213573255708
39578,1614418,gp,fileupload,GI+STARTS,10,1653996,0.9150872751384737
40017,1644208,gp,fileupload,GI+STARTS,11,1684225,0.9318117250405055
40181,1594868,gp,fileupload,GI+STARTS,12,1635049,0.9046046871503234
38859,1388539,gp,fileupload,GI+STARTS,13,1427398,0.7897200152588683
40593,2103178,gp,fileupload,GI+STARTS,14,2143771,1.186059436002796
39144,1331417,gp,fileupload,GI+STARTS,15,1370561,0.7582744643282461
40377,1750268,gp,fileupload,GI+STARTS,16,1790645,0.9906894900533811
41732,2026610,gp,fileupload,GI+STARTS,17,2068342,1.1443277038363218
40388,1443582,gp,fileupload,GI+STARTS,18,1483970,0.8210189526983384
40005,1840682,gp,fileupload,GI+STARTS,19,1880687,1.0405059880545966
40553,1989333,gp,fileupload,GI+STARTS,20,2029886,1.123051596607087
23291,2281634,gp,fileupload,GI+Random,1,2304925,1.275219249410849
22822,1692572,gp,fileupload,GI+Random,2,1715394,0.9490562378922844
23049,1722981,gp,fileupload,GI+Random,3,1746030,0.9660058639863877
23996,1791892,gp,fileupload,GI+Random,4,1815888,1.0046553932879236
22458,1614037,gp,fileupload,GI+Random,5,1636495,0.9054046988794027
22452,1678927,gp,fileupload,GI+Random,6,1701379,0.9413023206149357
22405,1749063,gp,fileupload,GI+Random,7,1771468,0.9800796526200799
24327,2193542,gp,fileupload,GI+Random,8,2217869,1.2270547811627668
22957,2026291,gp,fileupload,GI+Random,9,2049248,1.1337637868549664
22855,1542136,gp,fileupload,GI+Random,10,1564991,0.8658445061573516
23034,2183118,gp,fileupload,GI+Random,11,2206152,1.2205722518200128
22554,1930025,gp,fileupload,GI+Random,12,1952579,1.0802808450580326
22398,1836723,gp,fileupload,GI+Random,13,1859121,1.0285744161670973
22921,2976493,gp,fileupload,GI+Random,14,2999414,1.659451162077895
23587,1219358,gp,fileupload,GI+Random,15,1242945,0.6876698330570269
22479,2360598,gp,fileupload,GI+Random,16,2383077,1.3184575043562188
22615,1641595,gp,fileupload,GI+Random,17,1664210,0.920738257020089
22455,3545145,gp,fileupload,GI+Random,18,3567600,1.9738048718279964
22645,2137227,gp,fileupload,GI+Random,19,2159872,1.1949674504218182
23621,2464056,gp,fileupload,GI+Random,20,2487677,1.3763283389770307
205478,4763120,gp,imaging,GI,1,4968598,0.7847316052889725
185251,7714341,gp,imaging,GI,2,7899592,1.2476476284231337
182268,5245250,gp,imaging,GI,3,5427518,0.8572126207181168
190862,6956021,gp,imaging,GI,4,7146883,1.1287660964727813
190274,5632839,gp,imaging,GI,5,5823113,0.9196921973299278
184891,8242901,gp,imaging,GI,6,8427792,1.3310706048671195
179316,6483042,gp,imaging,GI,7,6662358,1.0522410725017053
189010,5444801,gp,imaging,GI,8,5633811,0.8897941733109966
186173,13437228,gp,imaging,GI,9,13623401,2.151655927129825
177473,7640577,gp,imaging,GI,10,7818050,1.2347690287540773
179016,5540249,gp,imaging,GI,11,5719265,0.9032906273606831
184575,7200549,gp,imaging,GI,12,7385124,1.1663934598408077
184566,5334427,gp,imaging,GI,13,5518993,0.8716600208889111
179613,4884508,gp,imaging,GI,14,5064121,0.7998183394405417
178275,6291749,gp,imaging,GI,15,6470024,1.0218641797501387
176431,21797032,gp,imaging,GI,16,21973463,3.4704499928848827
179965,6610251,gp,imaging,GI,17,6790216,1.0724347395258915
180818,5492797,gp,imaging,GI,18,5673615,0.8960807468709672
184942,6008212,gp,imaging,GI,19,6193154,0.9781358202498615
186779,4115413,gp,imaging,GI,20,4302192,0.679480616950974
226191,4607715,gp,imaging,GI+Ekstazi,1,4833906,0.7634585883575198
222983,4553688,gp,imaging,GI+Ekstazi,2,4776671,0.7544189933996032
230751,5514555,gp,imaging,GI+Ekstazi,3,5745306,0.9074034969736665
228295,5294363,gp,imaging,GI+Ekstazi,4,5522658,0.8722388645251611
228169,4908639,gp,imaging,GI+Ekstazi,5,5136808,0.811298396026653
226611,5752075,gp,imaging,GI+Ekstazi,6,5978686,0.9442631225747596
226442,4378671,gp,imaging,GI+Ekstazi,7,4605113,0.727323425446598
230923,4770037,gp,imaging,GI+Ekstazi,8,5000960,0.7898428024939711
230359,6580807,gp,imaging,GI+Ekstazi,9,6811166,1.0757435455775792
224340,4992297,gp,imaging,GI+Ekstazi,10,5216637,0.823906447496829
227970,5022651,gp,imaging,GI+Ekstazi,11,5250621,0.8292738205211994
225930,4750469,gp,imaging,GI+Ekstazi,12,4976399,0.7859636814707966
233018,4823265,gp,imaging,GI+Ekstazi,13,5056283,0.7985804195439723
228517,4369096,gp,imaging,GI+Ekstazi,14,4597613,0.7261388886739174
229313,4152356,gp,imaging,GI+Ekstazi,15,4381669,0.692033074161952
225756,16101299,gp,imaging,GI+Ekstazi,16,16327055,2.5786662716104916
228879,4710405,gp,imaging,GI+Ekstazi,17,4939284,0.7801018038283912
237089,4923483,gp,imaging,GI+Ekstazi,18,5160572,0.8150516402754506
236390,4657921,gp,imaging,GI+Ekstazi,19,4894311,0.7729988475246893
226998,4128108,gp,imaging,GI+Ekstazi,20,4355106,0.6878377607895901
315545,4654069,gp,imaging,GI+STARTS,1,4969614,0.7848920705371116
321234,6648339,gp,imaging,GI+STARTS,2,6969573,1.1007620677842482
316790,5632186,gp,imaging,GI+STARTS,3,5948976,0.9395707775725809
319331,6749294,gp,imaging,GI+STARTS,4,7068625,1.1164061659719227
319206,5634097,gp,imaging,GI+STARTS,5,5953303,0.9402541763212995
322783,8066962,gp,imaging,GI+STARTS,6,8389745,1.3250615287884289
308988,5399543,gp,imaging,GI+STARTS,7,5708531,0.9015953183316227
317264,7265570,gp,imaging,GI+STARTS,8,7582834,1.197619428551032
318621,7468584,gp,imaging,GI+STARTS,9,7787205,1.2298974238536329
309010,5830347,gp,imaging,GI+STARTS,10,6139357,0.9696392169485417
300071,5916449,gp,imaging,GI+STARTS,11,6216520,0.9818262050805888
317089,5687847,gp,imaging,GI+STARTS,12,6004936,0.9484090012791417
302758,4754336,gp,imaging,GI+STARTS,13,5057094,0.7987085074536582
303820,4083516,gp,imaging,GI+STARTS,14,4387336,0.6929281101473895
306897,6229923,gp,imaging,GI+STARTS,15,6536820,1.0324138221858683
304047,19743932,gp,imaging,GI+STARTS,16,20047979,3.1663424457904643
293171,7533001,gp,imaging,GI+STARTS,17,7826172,1.2360518031097723
312199,6200859,gp,imaging,GI+STARTS,18,6513058,1.0286608938135435
314554,4484757,gp,imaging,GI+STARTS,19,4799311,0.757994715070735
309361,4499656,gp,imaging,GI+STARTS,20,4809017,0.7595276635928201
200425,1928573,gp,imaging,GI+Random,1,2128998,0.33625018932846085
192558,2034191,gp,imaging,GI+Random,2,2226749,0.3516888098706344
190842,2230489,gp,imaging,GI+Random,3,2421331,0.3824207477775326
193372,1860776,gp,imaging,GI+Random,4,2054148,0.3244285123371084
190086,2716608,gp,imaging,GI+Random,5,2906694,0.45907812399067593
191196,2933742,gp,imaging,GI+Random,6,3124938,0.4935471964462633
186926,1656715,gp,imaging,GI+Random,7,1843641,0.29118140801621833
181769,4749380,gp,imaging,GI+Random,8,4931149,0.7788169762756237
190860,4793599,gp,imaging,GI+Random,9,4984459,0.7872366636558374
182221,2459546,gp,imaging,GI+Random,10,2641767,0.41723602084721545
179452,2212387,gp,imaging,GI+Random,11,2391839,0.3777628333108798
190857,2825911,gp,imaging,GI+Random,12,3016768,0.4764630174194819
179728,2349542,gp,imaging,GI+Random,13,2529270,0.3994684430717155
181741,2640021,gp,imaging,GI+Random,14,2821762,0.4456641137003681
181842,2335223,gp,imaging,GI+Random,15,2517065,0.39754080689697324
188266,8082811,gp,imaging,GI+Random,16,8271077,1.3063193141563674
181996,2333941,gp,imaging,GI+Random,17,2515937,0.3973626525663621
189261,2802809,gp,imaging,GI+Random,18,2992070,0.4725622588579265
189776,1499502,gp,imaging,GI+Random,19,1689278,0.2668015880373789
184211,2161355,gp,imaging,GI+Random,20,2345566,0.37045455729991317
45067,1937106,gp,text,GI,1,1982173,1.023481479932452
43760,2332347,gp,text,GI,2,2376107,1.22688660820113
43652,2125745,gp,text,GI,3,2169397,1.120153312612482
42617,1458820,gp,text,GI,4,1501437,0.7752567322758109
42542,5061838,gp,text,GI,5,5104380,2.635611723365019
42579,1648148,gp,text,GI,6,1690727,0.8729953299342463
42642,1848578,gp,text,GI,7,1891220,0.976518520067548
42380,1959660,gp,text,GI,8,2002040,1.0337396695868455
43919,1543557,gp,text,GI,9,1587476,0.8196823818290578
43570,2637812,gp,text,GI,10,2681382,1.384513267824876
42471,1670423,gp,text,GI,11,1712894,0.8844411088676001
42818,1523471,gp,text,GI,12,1566289,0.8087426191971742
42177,2413217,gp,text,GI,13,2455394,1.2678259087058814
40641,5875391,gp,text,GI,14,5916032,3.0547026857331545
40228,1434117,gp,text,GI,15,1474345,0.7612679632559877
43554,2474817,gp,text,GI,16,2518371,1.3003436521933096
42144,2040890,gp,text,GI,17,2083034,1.0755603678738512
44084,1398147,gp,text,GI,18,1442231,0.7446861188627129
42220,1644586,gp,text,GI,19,1686806,0.8709707483852013
41713,1772322,gp,text,GI,20,1814035,0.9366645728951335
55733,1077216,gp,text,GI+Ekstazi,1,1132949,0.5849904721777521
57194,1521541,gp,text,GI+Ekstazi,2,1578735,0.8151690262258439
57343,1077386,gp,text,GI+Ekstazi,3,1134729,0.5859095630110345
57224,1286402,gp,text,GI+Ekstazi,4,1343626,0.6937721011010244
56936,3736645,gp,text,GI+Ekstazi,5,3793581,1.9587896193337468
55361,1256119,gp,text,GI+Ekstazi,6,1311480,0.677173733726477
57214,1419692,gp,text,GI+Ekstazi,7,1476906,0.7625903181009518
56935,1220757,gp,text,GI+Ekstazi,8,1277692,0.6597275308753849
56567,857365,gp,text,GI+Ekstazi,9,913932,0.47190254126033687
55922,1274983,gp,text,GI+Ekstazi,10,1330905,0.6872036997020442
57876,1236904,gp,text,GI+Ekstazi,11,1294780,0.6685508028748954
55759,1096383,gp,text,GI+Ekstazi,12,1152142,0.5949006465390938
55354,1931806,gp,text,GI+Ekstazi,13,1987160,1.0260564832951369
57767,3839549,gp,text,GI+Ekstazi,14,3897316,2.0123524775306816
55093,1043161,gp,text,GI+Ekstazi,15,1098254,0.5670759460762179
56226,1312288,gp,text,GI+Ekstazi,16,1368514,0.7066228497857047
56751,3650074,gp,text,GI+Ekstazi,17,3706825,1.9139937517313632
56326,991660,gp,text,GI+Ekstazi,18,1047986,0.5411204078697928
57514,1222127,gp,text,GI+Ekstazi,19,1279641,0.6607338837035126
56139,1238886,gp,text,GI+Ekstazi,20,1295025,0.668677306950263
83978,1324527,gp,text,GI+STARTS,1,1408505,0.7272719292878362
84469,1713673,gp,text,GI+STARTS,2,1798142,0.9284583309775176
84960,1491415,gp,text,GI+STARTS,3,1576375,0.8139504563569976
85866,1050820,gp,text,GI+STARTS,4,1136686,0.5869200465844803
85037,3498768,gp,text,GI+STARTS,5,3583805,1.8504732156019283
81551,1073398,gp,text,GI+STARTS,6,1154949,0.5963500218025901
79690,1362084,gp,text,GI+STARTS,7,1441774,0.7444501500364151
80751,1206374,gp,text,GI+STARTS,8,1287125,0.6645981959486166
83373,1447007,gp,text,GI+STARTS,9,1530380,0.7902012524936147
84619,1527726,gp,text,GI+STARTS,10,1612345,0.8325233199936076
84523,1603855,gp,text,GI+STARTS,11,1688378,0.8717824398402124
86639,1491361,gp,text,GI+STARTS,12,1578000,0.8147895139997413
87511,1710709,gp,text,GI+STARTS,13,1798220,0.9284986057443694
87015,3575780,gp,text,GI+STARTS,14,3662795,1.8912591621867443
87655,999427,gp,text,GI+STARTS,15,1087082,0.5613073602394593
87088,1406168,gp,text,GI+STARTS,16,1493256,0.7710325288448655
85850,4078248,gp,text,GI+STARTS,17,4164098,2.1501035397131147
85807,1078230,gp,text,GI+STARTS,18,1164037,0.6010425484839778
84819,1396201,gp,text,GI+STARTS,19,1481020,0.7647145538807965
84672,1266268,gp,text,GI+STARTS,20,1350940,0.6975486350081183
43245,2140483,gp,text,GI+Random,1,2183728,1.1275530265067346
39324,2887661,gp,text,GI+Random,2,2926985,1.5113286981207432
41960,2340311,gp,text,GI+Random,3,2382271,1.2300693474687439
41372,1626176,gp,text,GI+Random,4,1667548,0.86102701171815
42517,6279463,gp,text,GI+Random,5,6321980,3.2643111607833237
40459,2437628,gp,text,GI+Random,6,2478087,1.2795432841439018
41064,1924671,gp,text,GI+Random,7,1965735,1.014993830990039
42270,2206448,gp,text,GI+Random,8,2248718,1.1611101687848353
40618,2166672,gp,text,GI+Random,9,2207290,1.139719104154936
40574,2667931,gp,text,GI+Random,10,2708505,1.3985180434828068
40860,1563522,gp,text,GI+Random,11,1604382,0.8284116793725811
42769,2335385,gp,text,GI+Random,12,2378154,1.2279435626594049
42041,1833842,gp,text,GI+Random,13,1875883,0.9685993649495417
42593,5042668,gp,text,GI+Random,14,5085261,2.6257397583978697
39856,1413017,gp,text,GI+Random,15,1452873,0.7501810428221458
42498,2203499,gp,text,GI+Random,16,2245997,1.1597051990335088
39590,6821240,gp,text,GI+Random,17,6860830,3.5425426751171387
39628,1315854,gp,text,GI+Random,18,1355482,0.6998938656624825
39340,1751346,gp,text,GI+Random,19,1790686,0.924608476341027
41701,1783341,gp,text,GI+Random,20,1825042,0.9423479621097058
86021,3348235,gp,validator,GI,1,3434256,1.6683062682882457
83006,4500072,gp,validator,GI,2,4583078,2.226385498184747
84733,2756685,gp,validator,GI,3,2841418,1.3803151134414704
82723,1601161,gp,validator,GI,4,1683884,0.8180037342208282
83462,815916,gp,validator,GI,5,899378,0.43690335110735656
88564,1554754,gp,validator,GI,6,1643318,0.7982974245923726
85366,1896026,gp,validator,GI,7,1981392,0.9625283303097334
84793,848270,gp,validator,GI,8,933063,0.4532669817299105
87844,1092212,gp,validator,GI,9,1180056,0.5732522041837167
85616,647042,gp,validator,GI,10,732658,0.35591345954160947
85637,2150719,gp,validator,GI,11,2236356,1.0863857362188574
86104,2049561,gp,validator,GI,12,2135665,1.0374716696902666
85031,662531,gp,validator,GI,13,747562,0.36315358276555315
83688,693775,gp,validator,GI,14,777463,0.37767900711600544
87070,3709523,gp,validator,GI,15,3796593,1.844323748736051
87645,2185019,gp,validator,GI,16,2272664,1.1040235780072998
88195,3971748,gp,validator,GI,17,4059943,1.9722549384183896
84943,3781439,gp,validator,GI,18,3866382,1.878226121231744
85438,828054,gp,validator,GI,19,913492,0.4437597050514482
86594,2786043,gp,validator,GI,20,2872637,1.3954808009702075
96267,1829723,gp,validator,GI+Ekstazi,1,1925990,0.9356149307624354
98959,1665325,gp,validator,GI+Ekstazi,2,1764284,0.8570607596640027
96413,1377091,gp,validator,GI+Ekstazi,3,1473504,0.7158045176445214
96655,2156308,gp,validator,GI+Ekstazi,4,2252963,1.0944531494220264
97697,1760342,gp,validator,GI+Ekstazi,5,1858039,0.9026054290722718
96916,2160098,gp,validator,GI+Ekstazi,6,2257014,1.0964210599950401
97409,1514913,gp,validator,GI+Ekstazi,7,1612322,0.7832400668730115
98400,789402,gp,validator,GI+Ekstazi,8,887802,0.4312799166977771
95688,2404343,gp,validator,GI+Ekstazi,9,2500031,1.2144748056682237
95082,1950596,gp,validator,GI+Ekstazi,10,2045678,0.9937574340117225
97877,2091663,gp,validator,GI+Ekstazi,11,2189540,1.0636432772244835
96042,1387363,gp,validator,GI+Ekstazi,12,1483405,0.7206142640240346
96422,485393,gp,validator,GI+Ekstazi,13,581815,0.28263635893309225
97865,547446,gp,validator,GI+Ekstazi,14,645311,0.31348169335522924
97443,569631,gp,validator,GI+Ekstazi,15,667074,0.32405380833930647
96102,1474343,gp,validator,GI+Ekstazi,16,1570445,0.7628968945535609
98542,2496225,gp,validator,GI+Ekstazi,17,2594767,1.2604960290809673
96272,2448418,gp,validator,GI+Ekstazi,18,2544690,1.2361694287934317
98287,595323,gp,validator,GI+Ekstazi,19,693610,0.33694456987114824
95964,1362188,gp,validator,GI+Ekstazi,20,1458152,0.7083467632340286
161010,833090,gp,validator,GI+STARTS,1,994100,0.4829177735455205
157261,2508079,gp,validator,GI+STARTS,2,2665340,1.294779256153121
158347,908394,gp,validator,GI+STARTS,3,1066741,0.5182056017198693
160628,1792968,gp,validator,GI+STARTS,4,1953596,0.9490254810657225
159334,602417,gp,validator,GI+STARTS,5,761751,0.3700463705020358
160585,582681,gp,validator,GI+STARTS,6,743266,0.3610666551373955
160179,2051412,gp,validator,GI+STARTS,7,2211591,1.0743552979713422
160338,569026,gp,validator,GI+STARTS,8,729364,0.35431328737979584
160609,773421,gp,validator,GI+STARTS,9,934030,0.45373673475980536
157425,511912,gp,validator,GI+STARTS,10,669337,0.3251531373017182
160355,2144486,gp,validator,GI+STARTS,11,2304841,1.119654646510845
159659,1948680,gp,validator,GI+STARTS,12,2108339,1.0241971388785727
163124,516243,gp,validator,GI+STARTS,13,679367,0.33002554980414406
160741,963535,gp,validator,GI+STARTS,14,1124276,0.5461551783227679
159993,600413,gp,validator,GI+STARTS,15,760406,0.36939299115849017
159214,1092449,gp,validator,GI+STARTS,16,1251663,0.608037731806968
159848,821777,gp,validator,GI+STARTS,17,981625,0.47685761941114735
160189,740937,gp,validator,GI+STARTS,18,901126,0.4377525013620166
156303,611961,gp,validator,GI+STARTS,19,768264,0.3732102810332721
155685,616253,gp,validator,GI+STARTS,20,771938,0.3749950510765335
89042,3566779,gp,validator,GI+Random,1,3655821,1.7759389777698
84546,3718309,gp,validator,GI+Random,2,3802855,1.847365727508752
84916,2113430,gp,validator,GI+Random,3,2198346,1.0679210902350877
82792,2920206,gp,validator,GI+Random,4,3002998,1.4588080757686863
82333,1023034,gp,validator,GI+Random,5,1105367,0.5369694905851438
82582,3819152,gp,validator,GI+Random,6,3901734,1.8953995536131756
86822,2320117,gp,validator,GI+Random,7,2406939,1.1692522109846912
83085,671455,gp,validator,GI+Random,8,754540,0.36654338280961374
85235,3183659,gp,validator,GI+Random,9,3268894,1.5879760712567255
78711,2006283,gp,validator,GI+Random,10,2084994,1.0128565137669943
84532,1991319,gp,validator,GI+Random,11,2075851,1.0084149915825795
84239,2530464,gp,validator,GI+Random,12,2614703,1.2701806168823992
81706,1151170,gp,validator,GI+Random,13,1232876,0.5989113097049664
86561,767515,gp,validator,GI+Random,14,854076,0.41489636893538273
86462,783768,gp,validator,GI+Random,15,870230,0.4227437220325101
84119,1979175,gp,validator,GI+Random,16,2063294,1.0023150031685255
81898,1700553,gp,validator,GI+Random,17,1782451,0.8658859957489051
87487,3243999,gp,validator,GI+Random,18,3331486,1.6183822570345758
86182,634256,gp,validator,GI+Random,19,720438,0.34997718030136576
83574,1392232,gp,validator,GI+Random,20,1475806,0.7169227921789764
18727,915500,gp,gson,GI,1,934227,0.9549464736385354
7047,957312,gp,gson,GI,2,964359,0.9857467471734217
6154,958704,gp,gson,GI,3,964858,0.9862568140954285
6449,1091742,gp,gson,GI,4,1098191,1.1225469000912804
6403,914790,gp,gson,GI,5,921193,0.9416234029743341
6329,1091841,gp,gson,GI,6,1098170,1.1225254343490718
6320,842332,gp,gson,GI,7,848652,0.8674735741380738
6696,881112,gp,gson,GI,8,887808,0.9074979837534997
5993,1319931,gp,gson,GI,9,1325924,1.355330608206251
6627,832314,gp,gson,GI,10,838941,0.8575472016338497
6185,986581,gp,gson,GI,11,992766,1.0147837633125933
6224,985524,gp,gson,GI,12,991748,1.0137431859045716
6390,919009,gp,gson,GI,13,925399,0.945922684485277
6666,1041784,gp,gson,GI,14,1048450,1.0717027342244683
6487,1288285,gp,gson,GI,15,1294772,1.323487712906942
6601,1030871,gp,gson,GI,16,1037472,1.060481261940319
5988,1072628,gp,gson,GI,17,1078616,1.1025377618181689
6344,1395533,gp,gson,GI,18,1401877,1.4329681090623252
6516,850253,gp,gson,GI,19,856769,0.8757705945908374
6583,941224,gp,gson,GI,20,947807,0.9688276536001628
7865,844639,gp,gson,GI+Ekstazi,1,852504,0.87141100456607
8146,732173,gp,gson,GI+Ekstazi,2,740319,0.7567379431525816
7677,1137938,gp,gson,GI+Ekstazi,3,1145615,1.1710226790677325
8303,740370,gp,gson,GI+Ekstazi,4,748673,0.7652772198388433
7585,829221,gp,gson,GI+Ekstazi,5,836806,0.855364851175965
7751,810236,gp,gson,GI+Ekstazi,6,817987,0.8361284796223665
7815,672760,gp,gson,GI+Ekstazi,7,680575,0.6956689287470241
7859,797600,gp,gson,GI+Ekstazi,8,805459,0.823322631127575
7474,750954,gp,gson,GI+Ekstazi,9,758428,0.7752485681838858
7648,989644,gp,gson,GI+Ekstazi,10,997292,1.0194101418476689
7332,883222,gp,gson,GI+Ekstazi,11,890554,0.9103048850918376
8799,759465,gp,gson,GI+Ekstazi,12,768264,0.7853027129631617
8336,877207,gp,gson,GI+Ekstazi,13,885543,0.9051827501295611
8694,833637,gp,gson,GI+Ekstazi,14,842331,0.8610123857332544
7821,990631,gp,gson,GI+Ekstazi,15,998452,1.0205958685601495
8552,735954,gp,gson,GI+Ekstazi,16,744506,0.7610178032777166
7629,1097935,gp,gson,GI+Ekstazi,17,1105564,1.1300834199629357
8538,800526,gp,gson,GI+Ekstazi,18,809064,0.8270075835400689
7914,739129,gp,gson,GI+Ekstazi,19,747043,0.7636110693721679
8369,711226,gp,gson,GI+Ekstazi,20,719595,0.7355543221271937
64312,1063348,gp,gson,GI+STARTS,1,1127660,1.1526694694792923
28566,1055701,gp,gson,GI+STARTS,2,1084267,1.1083140908287106
30912,866006,gp,gson,GI+STARTS,3,896918,0.9168100271592747
28642,940946,gp,gson,GI+STARTS,4,969588,0.9910917169833886
25036,881309,gp,gson,GI+STARTS,5,906345,0.9264461010545813
28718,836504,gp,gson,GI+STARTS,6,865222,0.8844110669189402
24287,1242667,gp,gson,GI+STARTS,7,1266954,1.2950527597278143
31066,854814,gp,gson,GI+STARTS,8,885880,0.9055272241831007
22244,1230498,gp,gson,GI+STARTS,9,1252742,1.280525563143525
22228,1152148,gp,gson,GI+STARTS,10,1174376,1.2004215462898509
22443,928105,gp,gson,GI+STARTS,11,950548,0.9716294440474986
20868,1058677,gp,gson,GI+STARTS,12,1079545,1.1034873653663537
21740,887467,gp,gson,GI+STARTS,13,909207,0.9293715750641672
23801,941026,gp,gson,GI+STARTS,14,964827,0.9862251265712156
23033,912245,gp,gson,GI+STARTS,15,935278,0.9560207829271709
27944,748989,gp,gson,GI+STARTS,16,776933,0.794163975782554
19639,916187,gp,gson,GI+STARTS,17,935826,0.956580936580998
28155,1295502,gp,gson,GI+STARTS,18,1323657,1.3530133302259115
22371,988719,gp,gson,GI+STARTS,19,1011090,1.0335141566569865
32603,1065702,gp,gson,GI+STARTS,20,1098305,1.1226634284061277
7158,872220,gp,gson,GI+Random,1,879378,0.8988810215240064
6858,932156,gp,gson,GI+Random,2,939014,0.959839640683919
6508,941060,gp,gson,GI+Random,3,947568,0.9685833530102637
6343,763147,gp,gson,GI+Random,4,769490,0.7865559034368698
7159,850049,gp,gson,GI+Random,5,857208,0.8762193308208193
6283,710535,gp,gson,GI+Random,6,716818,0.732715733264643
6259,814049,gp,gson,GI+Random,7,820308,0.8385009552255283
6848,638681,gp,gson,GI+Random,8,645529,0.6598456715353014
6981,819566,gp,gson,GI+Random,9,826547,0.8448783250179137
6769,893318,gp,gson,GI+Random,10,900087,0.920049309876388
6293,899139,gp,gson,GI+Random,11,905432,0.9255128523576029
6661,921223,gp,gson,GI+Random,12,927884,0.9484627973133068
7052,847231,gp,gson,GI+Random,13,854283,0.8732294595846072
6619,852419,gp,gson,GI+Random,14,859038,0.8780899169275777
6153,1103236,gp,gson,GI+Random,15,1109389,1.1339932515795208
7007,880145,gp,gson,GI+Random,16,887152,0.9068274348540278
6537,772086,gp,gson,GI+Random,17,778623,0.7958914569412544
6817,967197,gp,gson,GI+Random,18,974014,0.9956158776984226
6437,755578,gp,gson,GI+Random,19,762015,0.7789151213887722
6901,797964,gp,gson,GI+Random,20,804865,0.8227154572765288
45893,8353211,gp,jcodec,GI,1,8399104,0.8357481652002614
26179,10126577,gp,jcodec,GI,2,10152756,1.01024433067217
25687,6989659,gp,jcodec,GI,3,7015346,0.6980580961665664
23865,10620737,gp,jcodec,GI,4,10644602,1.0591851929428464
24810,5261117,gp,jcodec,GI,5,5285927,0.5259732218618226
26005,7125206,gp,jcodec,GI,6,7151211,0.7115772673144571
26736,7778420,gp,jcodec,GI,7,7805156,0.7766477002906276
25997,13842216,gp,jcodec,GI,8,13868213,1.3799488099392998
24558,9774166,gp,jcodec,GI,9,9798724,0.9750165737087868
23894,10170314,gp,jcodec,GI,10,10194208,1.0143689888433132
24858,11240899,gp,jcodec,GI,11,11265757,1.1209928752331202
25393,8522233,gp,jcodec,GI,12,8547626,0.8505267640831747
24199,14272980,gp,jcodec,GI,13,14297179,1.422632832834277
24849,13130277,gp,jcodec,GI,14,13155126,1.3089934851953557
25123,9921726,gp,jcodec,GI,15,9946849,0.9897556693278301
25618,11694318,gp,jcodec,GI,16,11719936,1.1661857036494
24710,13236891,gp,jcodec,GI,17,13261601,1.3195882207635423
25959,8698094,gp,jcodec,GI,18,8724053,0.8680820344479406
24882,9179953,gp,jcodec,GI,19,9204835,0.9159219795612898
24923,12017883,gp,jcodec,GI,20,12042806,1.1983127031600869
32841,1502394,gp,jcodec,GI+Ekstazi,1,1535235,0.1527627035456667
45606,2398709,gp,jcodec,GI+Ekstazi,2,2444315,0.24322020258607072
44842,2126390,gp,jcodec,GI+Ekstazi,3,2171232,0.21604723077891333
44946,1920507,gp,jcodec,GI+Ekstazi,4,1965453,0.19557130600327718
47259,2112353,gp,jcodec,GI+Ekstazi,5,2159612,0.21489098915127935
43657,2662531,gp,jcodec,GI+Ekstazi,6,2706188,0.26927772958722324
40686,3356174,gp,jcodec,GI+Ekstazi,7,3396860,0.33800266224137243
45788,2073653,gp,jcodec,GI+Ekstazi,8,2119441,0.2108937961716163
32288,3237555,gp,jcodec,GI+Ekstazi,9,3269843,0.32536390640512586
45900,2056024,gp,jcodec,GI+Ekstazi,10,2101924,0.20915077684362454
30727,2511417,gp,jcodec,GI+Ekstazi,11,2542144,0.2529546227400986
44456,2115401,gp,jcodec,GI+Ekstazi,12,2159857,0.2149153677398138
47485,2259080,gp,jcodec,GI+Ekstazi,13,2306565,0.22951346556312924
44026,2341565,gp,jcodec,GI+Ekstazi,14,2385591,0.23737690367547024
45510,2398621,gp,jcodec,GI+Ekstazi,15,2444131,0.24320189376855914
34609,2417967,gp,jcodec,GI+Ekstazi,16,2452576,0.24404220878967522
47877,1217521,gp,jcodec,GI+Ekstazi,17,1265398,0.12591272316048002
49577,1057751,gp,jcodec,GI+Ekstazi,18,1107328,0.11018405585582403
47236,1289729,gp,jcodec,GI+Ekstazi,19,1336965,0.13303395763250073
41314,3151731,gp,jcodec,GI+Ekstazi,20,3193045,0.3177221641917839
102581,8634181,gp,jcodec,GI+STARTS,1,8736762,0.8693466364139992
46376,11879897,gp,jcodec,GI+STARTS,2,11926273,1.186717151904229
42440,11974033,gp,jcodec,GI+STARTS,3,12016473,1.195692452662627
46635,11728471,gp,jcodec,GI+STARTS,4,11775106,1.1716753637695865
44447,7901681,gp,jcodec,GI+STARTS,5,7946128,0.7906750406289079
46871,11235964,gp,jcodec,GI+STARTS,6,11282835,1.122692212110636
43697,9643856,gp,jcodec,GI+STARTS,7,9687553,0.9639545652762828
41496,9633733,gp,jcodec,GI+STARTS,8,9675229,0.9627282725207784
48294,13563047,gp,jcodec,GI+STARTS,9,13611341,1.354388904657579
50179,9253019,gp,jcodec,GI+STARTS,10,9303198,0.9257095350878786
43606,12168788,gp,jcodec,GI+STARTS,11,12212394,1.2151874626391912
41762,7378247,gp,jcodec,GI+STARTS,12,7420009,0.7383238625833691
41137,11262294,gp,jcodec,GI+STARTS,13,11303431,1.124741605618618
51050,12112576,gp,jcodec,GI+STARTS,14,12163626,1.2103348299630763
39504,8203213,gp,jcodec,GI+STARTS,15,8242717,0.8201869638731707
43116,6674069,gp,jcodec,GI+STARTS,16,6717185,0.6683897519379112
40056,12127259,gp,jcodec,GI+STARTS,17,12167315,1.2107019018532952
40992,8356274,gp,jcodec,GI+STARTS,18,8397266,0.8355652760340315
41958,8308316,gp,jcodec,GI+STARTS,19,8350274,0.8308893632486808
40297,10960248,gp,jcodec,GI+STARTS,20,11000545,1.0946031028967982
25474,15725821,gp,jcodec,GI+Random,1,15751295,1.5673238354684085
25896,15806286,gp,jcodec,GI+Random,2,15832182,1.5753724513491683
24481,11957158,gp,jcodec,GI+Random,3,11981639,1.192226314895243
25500,14857153,gp,jcodec,GI+Random,4,14882653,1.4808900970939478
27715,10570214,gp,jcodec,GI+Random,5,10597929,1.054541022074812
25124,11336676,gp,jcodec,GI+Random,6,11361800,1.130549580451954
25484,13281977,gp,jcodec,GI+Random,7,13307461,1.3241514945194197
25591,8911142,gp,jcodec,GI+Random,8,8936733,0.8892446393847043
24933,12844004,gp,jcodec,GI+Random,9,12868937,1.2805164081582698
25422,9978873,gp,jcodec,GI+Random,10,10004295,0.9954718015602794
24554,10116120,gp,jcodec,GI+Random,11,10140674,1.009042117991871
24212,9277883,gp,jcodec,GI+Random,12,9302095,0.9255997816872521
24405,13242604,gp,jcodec,GI+Random,13,13267009,1.3201263407912742
25849,14929897,gp,jcodec,GI+Random,14,14955746,1.4881631753459832
24794,17622773,gp,jcodec,GI+Random,15,17647567,1.7560113246006577
24623,14050454,gp,jcodec,GI+Random,16,14075077,1.4005326970355885
24684,13243004,gp,jcodec,GI+Random,17,13267688,1.3201939043080697
25198,7627725,gp,jcodec,GI+Random,18,7652923,0.7614998404197495
25182,15729700,gp,jcodec,GI+Random,19,15754882,1.5676807579054415
25215,12250005,gp,jcodec,GI+Random,20,12275220,1.2214389287749685
23547,13705278,gp,jfreechart,GI,1,13728825,2.8757581848034905
10652,13775429,gp,jfreechart,GI,2,13786081,2.887751520768448
10485,15861900,gp,jfreechart,GI,3,15872385,3.3247667645339023
10342,6868119,gp,jfreechart,GI,4,6878461,1.4408218124713223
10459,15030381,gp,jfreechart,GI,5,15040840,3.150584171356233
10184,4143349,gp,jfreechart,GI,6,4153533,0.8700348733851146
10069,5089852,gp,jfreechart,GI,7,5099921,1.0682734726097247
10973,3265439,gp,jfreechart,GI,8,3276412,0.6863055378583655
10005,21253615,gp,jfreechart,GI,9,21263620,4.4540613820593675
10135,4817887,gp,jfreechart,GI,10,4828022,1.0113191611744865
10085,3770792,gp,jfreechart,GI,11,3780877,0.7919751310461942
10813,4464853,gp,jfreechart,GI,12,4475666,0.9375116320549428
10415,4820910,gp,jfreechart,GI,13,4831325,1.012011036064319
9984,4025578,gp,jfreechart,GI,14,4035562,0.8453236494588535
9991,4449609,gp,jfreechart,GI,15,4459600,0.9341463090213217
10351,39073456,gp,jfreechart,GI,16,39083807,8.186831565959212
10319,4603810,gp,jfreechart,GI,17,4614129,0.9665152871778281
10623,3735701,gp,jfreechart,GI,18,3746324,0.7847373614220993
10557,4709390,gp,jfreechart,GI,19,4719947,0.9886808388255136
11190,3753590,gp,jfreechart,GI,20,3764780,0.7886033144849968
13840,1683877,gp,jfreechart,GI+Ekstazi,1,1697717,0.35561845665816466
14787,1463225,gp,jfreechart,GI+Ekstazi,2,1478012,0.3095971509752493
13100,1472951,gp,jfreechart,GI+Ekstazi,3,1486051,0.3112810693038488
13333,1160292,gp,jfreechart,GI+Ekstazi,4,1173625,0.2458376226399562
13755,1488844,gp,jfreechart,GI+Ekstazi,5,1502599,0.31474735621785116
13560,1247545,gp,jfreechart,GI+Ekstazi,6,1261105,0.2641619385232608
13619,1680750,gp,jfreechart,GI+Ekstazi,7,1694369,0.3549171556799148
13650,1623330,gp,jfreechart,GI+Ekstazi,8,1636980,0.3428959603869682
13260,1928940,gp,jfreechart,GI+Ekstazi,9,1942200,0.40682997609229776
12834,1372553,gp,jfreechart,GI+Ekstazi,10,1385387,0.29019511898289574
12532,1825866,gp,jfreechart,GI+Ekstazi,11,1838398,0.385086713205709
13377,1509522,gp,jfreechart,GI+Ekstazi,12,1522899,0.31899956943722796
12984,1755201,gp,jfreechart,GI+Ekstazi,13,1768185,0.37037929218245264
12905,1623125,gp,jfreechart,GI+Ekstazi,14,1636030,0.34269696518704656
13470,1714851,gp,jfreechart,GI+Ekstazi,15,1728321,0.36202903465648034
13250,1583375,gp,jfreechart,GI+Ekstazi,16,1596625,0.33444285376293115
13195,1792370,gp,jfreechart,GI+Ekstazi,17,1805565,0.37820922962778786
13226,1589499,gp,jfreechart,GI+Ekstazi,18,1602725,0.3357206124150592
13357,1374458,gp,jfreechart,GI+Ekstazi,19,1387815,0.290703708820169
12201,1472442,gp,jfreechart,GI+Ekstazi,20,1484643,0.31098613747070186
43023,5421204,gp,jfreechart,GI+STARTS,1,5464227,1.14458415187565
25758,1368410,gp,jfreechart,GI+STARTS,2,1394168,0.29203446303606556
30554,1615706,gp,jfreechart,GI+STARTS,3,1646260,0.3448398292872547
26624,1079423,gp,jfreechart,GI+STARTS,4,1106047,0.23168215146069285
25849,1733716,gp,jfreechart,GI+STARTS,5,1759565,0.3685736725789537
26228,1375103,gp,jfreechart,GI+STARTS,6,1401331,0.29353488684347423
25593,1676248,gp,jfreechart,GI+STARTS,7,1701841,0.3564823052944558
29382,1664234,gp,jfreechart,GI+STARTS,8,1693616,0.354759425800398
25144,1673764,gp,jfreechart,GI+STARTS,9,1698908,0.3558679337982769
24641,1480148,gp,jfreechart,GI+STARTS,10,1504789,0.31520609252082826
26681,1246963,gp,jfreechart,GI+STARTS,11,1273644,0.2667884656935941
25718,1486937,gp,jfreechart,GI+STARTS,12,1512655,0.3168537727761789
28125,802777,gp,jfreechart,GI+STARTS,13,830902,0.17404790484761734
24985,1511291,gp,jfreechart,GI+STARTS,14,1536276,0.32180163132075523
25099,1338525,gp,jfreechart,GI+STARTS,15,1363624,0.2856364531556397
24930,1080069,gp,jfreechart,GI+STARTS,16,1104999,0.23146262833488462
26237,1318802,gp,jfreechart,GI+STARTS,17,1345039,0.2817434786392792
30196,1376513,gp,jfreechart,GI+STARTS,18,1406709,0.29466140914366185
25363,1468491,gp,jfreechart,GI+STARTS,19,1493854,0.3129155530354152
25544,1288280,gp,jfreechart,GI+STARTS,20,1313824,0.27520491530711927
9912,1379697,gp,jfreechart,GI+Random,1,1389609,0.2910794955450735
9497,2180386,gp,jfreechart,GI+Random,2,2189883,0.45871179514721927
9604,3207183,gp,jfreechart,GI+Random,3,3216787,0.6738159707053929
9777,3181725,gp,jfreechart,GI+Random,4,3191502,0.6685195563580066
9551,3078476,gp,jfreechart,GI+Random,5,3088027,0.6468447897139171
9189,2052614,gp,jfreechart,GI+Random,6,2061803,0.43188305282516104
9537,1049297,gp,jfreechart,GI+Random,7,1058834,0.22179250896185357
10063,683097,gp,jfreechart,GI+Random,8,693160,0.14519527660804094
9838,1962727,gp,jfreechart,GI+Random,9,1972565,0.4131904910876858
9653,1989462,gp,jfreechart,GI+Random,10,1999115,0.41875188325391505
9197,2771315,gp,jfreechart,GI+Random,11,2780512,0.5824300434993034
9708,1162189,gp,jfreechart,GI+Random,12,1171897,0.24547566084473044
9988,1842923,gp,jfreechart,GI+Random,13,1852911,0.3881267314546162
9476,1127619,gp,jfreechart,GI+Random,14,1137095,0.2381857335313929
11194,1472863,gp,jfreechart,GI+Random,15,1484057,0.310863388852645
9681,2287005,gp,jfreechart,GI+Random,16,2296686,0.4810836733969287
9904,1629493,gp,jfreechart,GI+Random,17,1639397,0.3434022460692949
9888,2658620,gp,jfreechart,GI+Random,18,2668508,0.5589687188971811
9806,1772521,gp,jfreechart,GI+Random,19,1782327,0.37334159756907465
9422,1537494,gp,jfreechart,GI+Random,20,1546916,0.32403037755987685
22978,1700108,gp,joda-time,GI,1,1723086,1.0994724008235104
9894,1650637,gp,joda-time,GI,2,1660531,1.0595571000007338
9294,1126844,gp,joda-time,GI,3,1136138,0.7249506841369621
9303,2130880,gp,joda-time,GI,4,2140183,1.365615030945445
24441,1147854,gp,joda-time,GI,5,1172295,0.7480218620100199
412343,1098208,gp,joda-time,GI,6,1510551,0.963857366687649
17153,1611317,gp,joda-time,GI,7,1628470,1.0390995113239048
26171,2169748,gp,joda-time,GI,8,2195919,1.4011792417464723
13561,1422384,gp,joda-time,GI,9,1435945,0.916252524018253
15045,1345343,gp,joda-time,GI,10,1360388,0.8680408641306897
9137,2367164,gp,joda-time,GI,11,2376301,1.5162779835419173
14531,2274397,gp,joda-time,GI,12,2288928,1.460526731383202
9720,1614116,gp,joda-time,GI,13,1623836,1.0361426333123511
10444,1774336,gp,joda-time,GI,14,1784780,1.1388383119251069
9137,1104234,gp,joda-time,GI,15,1113371,0.7104234416490369
9274,1124029,gp,joda-time,GI,16,1133303,0.7231417179818573
9870,1111118,gp,joda-time,GI,17,1120988,0.7152837221440748
10306,1735131,gp,joda-time,GI,18,1745437,1.1137342006586934
9538,1110989,gp,joda-time,GI,19,1120527,0.714989565742839
9546,1442726,gp,joda-time,GI,20,1452272,0.9266705100550762
12480,787994,gp,joda-time,GI+Ekstazi,1,800474,0.5107690913725714
11029,372721,gp,joda-time,GI+Ekstazi,2,383750,0.24486446632148487
11397,806564,gp,joda-time,GI+Ekstazi,3,817961,0.5219272540372328
10726,598508,gp,joda-time,GI+Ekstazi,4,609234,0.3887420411072404
11259,773420,gp,joda-time,GI+Ekstazi,5,784679,0.5006905656512741
11168,525080,gp,joda-time,GI+Ekstazi,6,536248,0.34217089338361856
11658,920851,gp,joda-time,GI+Ekstazi,7,932509,0.5950184198696588
11463,477019,gp,joda-time,GI+Ekstazi,8,488482,0.3116922064824797
11083,977464,gp,joda-time,GI+Ekstazi,9,988547,0.6307753318272441
11124,1179859,gp,joda-time,GI+Ekstazi,10,1190983,0.7599463627178137
11506,1047176,gp,joda-time,GI+Ekstazi,11,1058682,0.6755273040629635
11051,663761,gp,joda-time,GI+Ekstazi,12,674812,0.43058626774549535
11072,860653,gp,joda-time,GI+Ekstazi,13,871725,0.5562331645709352
10876,670141,gp,joda-time,GI+Ekstazi,14,681017,0.4345455746211301
10757,1200080,gp,joda-time,GI+Ekstazi,15,1210837,0.772614868553245
10720,787039,gp,joda-time,GI+Ekstazi,16,797759,0.5090366952134501
10667,766549,gp,joda-time,GI+Ekstazi,17,777216,0.4959285499844148
11026,738402,gp,joda-time,GI+Ekstazi,18,749428,0.47819749124788996
11124,686477,gp,joda-time,GI+Ekstazi,19,697601,0.4451275480660174
10744,828856,gp,joda-time,GI+Ekstazi,20,839600,0.5357347385629152
9442,1061259,gp,joda-time,GI+Random,1,1070701,0.6831964272439874
9085,631476,gp,joda-time,GI+Random,2,640561,0.4087312766419718
8866,1040682,gp,joda-time,GI+Random,3,1049548,0.6696990512020373
9559,781073,gp,joda-time,GI+Random,4,790632,0.504489075535344
9255,989140,gp,joda-time,GI+Random,5,998395,0.6370591761642708
8904,816361,gp,joda-time,GI+Random,6,825265,0.5265878144594143
9432,1404074,gp,joda-time,GI+Random,7,1413506,0.9019345728526822
9737,1311284,gp,joda-time,GI+Random,8,1321021,0.8429214388650795
8797,1470960,gp,joda-time,GI+Random,9,1479757,0.9442082295517433
9005,2076757,gp,joda-time,GI+Random,10,2085762,1.330889899683734
9154,2009361,gp,joda-time,GI+Random,11,2018515,1.2879807120180118
8914,1138049,gp,joda-time,GI+Random,12,1146963,0.7318579358579524
8725,1403118,gp,joda-time,GI+Random,13,1411843,0.9008734403250142
8829,1059521,gp,joda-time,GI+Random,14,1068350,0.6816962934060152
8718,2278149,gp,joda-time,GI+Random,15,2286867,1.4592116417021892
8707,1020815,gp,joda-time,GI+Random,16,1029522,0.65692079503903
9382,935037,gp,joda-time,GI+Random,17,944419,0.6026179919709979
8952,1346284,gp,joda-time,GI+Random,18,1355236,0.8647534589698082
9068,1027871,gp,joda-time,GI+Random,19,1036939,0.6616534588740957
8580,1295188,gp,joda-time,GI+Random,20,1303768,0.8319125876925855
22996,2022931,gp,spatial4j,GI,1,2045927,0.8076412855218423
10946,1772294,gp,spatial4j,GI,2,1783240,0.7039441025969989
12396,2124427,gp,spatial4j,GI,3,2136823,0.8435229969850535
10916,2015017,gp,spatial4j,GI,4,2025933,0.7997485406376291
13242,2698539,gp,spatial4j,GI,5,2711781,1.0704909280212378
13257,2750178,gp,spatial4j,GI,6,2763435,1.090881637446523
10756,3024321,gp,spatial4j,GI,7,3035077,1.1981138574043828
9387,5681843,gp,spatial4j,GI,8,5691230,2.2466453169641314
9022,4372494,gp,spatial4j,GI,9,4381516,1.7296282881913776
9049,2032173,gp,spatial4j,GI,10,2041222,0.8057839600902017
8801,1862837,gp,spatial4j,GI,11,1871638,0.7388397143942721
9776,2578111,gp,spatial4j,GI,12,2587887,1.0215830689292746
9301,2469237,gp,spatial4j,GI,13,2478538,0.9784169310707254
10696,2326057,gp,spatial4j,GI,14,2336753,0.9224464982704768
9511,2791570,gp,spatial4j,GI,15,2801081,1.1057426094336738
11425,2039261,gp,spatial4j,GI,16,2050686,0.8095199277597123
11061,3082285,gp,spatial4j,GI,17,3093346,1.2211158755927503
10020,2900659,gp,spatial4j,GI,18,2910679,1.14900704145428
9671,1892150,gp,spatial4j,GI,19,1901821,0.750754624809407
11135,2674625,gp,spatial4j,GI,20,2685760,1.0602189907084385
12783,2543315,gp,spatial4j,GI+Ekstazi,1,2556098,1.0090341809066552
12343,2084633,gp,spatial4j,GI+Ekstazi,2,2096976,0.8277931677662257
10999,1417106,gp,spatial4j,GI+Ekstazi,3,1428105,0.5637525474076889
11558,2032732,gp,spatial4j,GI+Ekstazi,4,2044290,0.8069950704885595
12507,2940410,gp,spatial4j,GI+Ekstazi,5,2952917,1.1656807314822581
15396,1785074,gp,spatial4j,GI+Ekstazi,6,1800470,0.7107457428068115
12087,1799759,gp,spatial4j,GI+Ekstazi,7,1811846,0.7152364833191057
12904,1430934,gp,spatial4j,GI+Ekstazi,8,1443838,0.5699632383781463
12467,2063548,gp,spatial4j,GI+Ekstazi,9,2076015,0.8195186941482406
13280,1896977,gp,spatial4j,GI+Ekstazi,10,1910257,0.7540847836492202
14306,2229007,gp,spatial4j,GI+Ekstazi,11,2243313,0.8855605283804655
13132,1820325,gp,spatial4j,GI+Ekstazi,12,1833457,0.7237675481231836
12226,1572860,gp,spatial4j,GI+Ekstazi,13,1585086,0.6257216873831153
11440,4600050,gp,spatial4j,GI+Ekstazi,14,4611490,1.8204118288536788
12523,1922481,gp,spatial4j,GI+Ekstazi,15,1935004,0.7638538022372777
11214,1825877,gp,spatial4j,GI+Ekstazi,16,1837091,0.7252020902312775
10779,1760276,gp,spatial4j,GI+Ekstazi,17,1771055,0.699134004746937
11950,4737017,gp,spatial4j,GI+Ekstazi,18,4748967,1.8746816542236389
14394,2853377,gp,spatial4j,GI+Ekstazi,19,2867771,1.1320688651267905
14986,2006475,gp,spatial4j,GI+Ekstazi,20,2021461,0.7979831932773109
23015,2228062,gp,spatial4j,GI+STARTS,1,2251077,0.8886254114094257
19449,2227479,gp,spatial4j,GI+STARTS,2,2246928,0.8869875701308122
20827,2618205,gp,spatial4j,GI+STARTS,3,2639032,1.0417728477180654
22345,2544891,gp,spatial4j,GI+STARTS,4,2567236,1.0134309695692723
18452,3690634,gp,spatial4j,GI+STARTS,5,3709086,1.4641827324000651
18522,2717141,gp,spatial4j,GI+STARTS,6,2735663,1.0799184829539568
19226,1672715,gp,spatial4j,GI+STARTS,7,1691941,0.6679033045984101
17731,2608898,gp,spatial4j,GI+STARTS,8,2626629,1.0368766931317448
19896,2807604,gp,spatial4j,GI+STARTS,9,2827500,1.116171659503496
18630,2309582,gp,spatial4j,GI+STARTS,10,2328212,0.9190748900852179
29862,2419290,gp,spatial4j,GI+STARTS,11,2449152,0.9668166409253073
19213,2659544,gp,spatial4j,GI+STARTS,12,2678757,1.0574545167450422
25283,2167027,gp,spatial4j,GI+STARTS,13,2192310,0.8654268048969441
19174,2604709,gp,spatial4j,GI+STARTS,14,2623883,1.0357926940594206
18659,3421807,gp,spatial4j,GI+STARTS,15,3440466,1.3581434640797012
18660,1954808,gp,spatial4j,GI+STARTS,16,1973468,0.7790376843632344
19138,2921264,gp,spatial4j,GI+STARTS,17,2940402,1.1607403642607954
21083,2090337,gp,spatial4j,GI+STARTS,18,2111420,0.8334950186768777
18426,1850556,gp,spatial4j,GI+STARTS,19,1868982,0.73779124333233
20386,2881683,gp,spatial4j,GI+STARTS,20,2902069,1.1456081951277282
10247,1373781,gp,spatial4j,GI+Random,1,1384028,0.5463529017009034
9400,1745866,gp,spatial4j,GI+Random,2,1755266,0.6929012074589084
10103,1445504,gp,spatial4j,GI+Random,3,1455607,0.5746091178691088
8943,1044407,gp,spatial4j,GI+Random,4,1053350,0.4158158859550867
9489,1334079,gp,spatial4j,GI+Random,5,1343568,0.5303810872558066
9741,1503468,gp,spatial4j,GI+Random,6,1513209,0.5973478340249782
9029,1424438,gp,spatial4j,GI+Random,7,1433467,0.5658692273151187
9551,1189136,gp,spatial4j,GI+Random,8,1198687,0.4731884908984146
10547,1284506,gp,spatial4j,GI+Random,9,1295053,0.5112295158815141
11610,1362420,gp,spatial4j,GI+Random,10,1374030,0.542406134503126
11309,1814192,gp,spatial4j,GI+Random,11,1825501,0.7206268720054082
9594,1595896,gp,spatial4j,GI+Random,12,1605490,0.6337762820924024
9267,929702,gp,spatial4j,GI+Random,13,938969,0.3706633375605086
11757,1526425,gp,spatial4j,GI+Random,14,1538182,0.6072060673946619
9821,1249067,gp,spatial4j,GI+Random,15,1258888,0.496953177042984
9169,1407145,gp,spatial4j,GI+Random,16,1416314,0.5590979832919662
10404,1522219,gp,spatial4j,GI+Random,17,1532623,0.6050116206200624
10855,1711549,gp,spatial4j,GI+Random,18,1722404,0.6799287466014003
9693,1604285,gp,spatial4j,GI+Random,19,1613978,0.6371269682271029
10529,1603850,gp,spatial4j,GI+Random,20,1614379,0.6372852652511386
62536,4040388,ls,codec,GI,1,4102924,0.7779434627695585
65143,7137880,ls,codec,GI,2,7203023,1.3657441997533402
64352,4410431,ls,codec,GI,3,4474783,0.84845056407634
63597,7282769,ls,codec,GI,4,7346366,1.3929230482486514
66969,7134582,ls,codec,GI,5,7201551,1.365465098123089
64278,9209245,ls,codec,GI,6,9273523,1.7583256708369797
64519,6870727,ls,codec,GI,7,6935246,1.3149717831475136
66217,4510032,ls,codec,GI,8,4576249,0.8676892366409247
67003,3755313,ls,codec,GI,9,3822316,0.7247381976462366
66244,6075643,ls,codec,GI,10,6141887,1.1645452951893174
66254,5682476,ls,codec,GI,11,5748730,1.0899999421698388
64750,4338387,ls,codec,GI,12,4403137,0.8348659748093714
63125,5804847,ls,codec,GI,13,5867972,1.112609070291044
65613,4453873,ls,codec,GI,14,4519486,0.8569265696314484
64961,4734438,ls,codec,GI,15,4799399,0.9100000578301611
63956,4704242,ls,codec,GI,16,4768198,0.9040841271470987
65609,8467406,ls,codec,GI,17,8533015,1.6179201069687335
64486,4677766,ls,codec,GI,18,4742252,0.8991645816997498
63428,6423378,ls,codec,GI,19,6486806,1.229944381605496
63718,3867435,ls,codec,GI,20,3931153,0.7453744640400207
75751,1206385,ls,codec,GI+Ekstazi,1,1282136,0.24310207051885693
75070,1340947,ls,codec,GI+Ekstazi,2,1416017,0.26848685676862694
74448,1378988,ls,codec,GI+Ekstazi,3,1453436,0.27558176431099773
71543,1205525,ls,codec,GI+Ekstazi,4,1277068,0.24214114180818228
75717,1445114,ls,codec,GI+Ekstazi,5,1520831,0.2883603338563645
71191,1721774,ls,codec,GI+Ekstazi,6,1792965,0.3399588685348842
72437,1627189,ls,codec,GI+Ekstazi,7,1699626,0.32226113275634
70378,1425999,ls,codec,GI+Ekstazi,8,1496377,0.28372368218098204
71247,1064561,ls,codec,GI+Ekstazi,9,1135808,0.2153572448725267
72746,1637465,ls,codec,GI+Ekstazi,10,1710211,0.3242681237591994
75241,1174849,ls,codec,GI+Ekstazi,11,1250090,0.23702592184832022
74882,1110754,ls,codec,GI+Ekstazi,12,1185636,0.22480498674219854
72432,1267327,ls,codec,GI+Ekstazi,13,1339759,0.2540277996220941
71311,1730174,ls,codec,GI+Ekstazi,14,1801485,0.3415743209056317
71070,1428337,ls,codec,GI+Ekstazi,15,1499407,0.28429819165086057
72720,1469044,ls,codec,GI+Ekstazi,16,1541764,0.29232937898275607
69467,1659556,ls,codec,GI+Ekstazi,17,1729023,0.32783501225667605
69984,1116299,ls,codec,GI+Ekstazi,18,1186283,0.22492766252669075
70990,6104350,ls,codec,GI+Ekstazi,19,6175340,1.1708882210295304
70943,994568,ls,codec,GI+Ekstazi,20,1065511,0.20202843556425978
105218,1204299,ls,codec,GI+STARTS,1,1309517,0.24829370213428373
105667,1541155,ls,codec,GI+STARTS,2,1646822,0.31224912019942114
108430,1535484,ls,codec,GI+STARTS,3,1643914,0.3116977427940064
110585,1429207,ls,codec,GI+STARTS,4,1539792,0.29195547380962067
110771,1389869,ls,codec,GI+STARTS,5,1500640,0.2845319771876131
106272,1674339,ls,codec,GI+STARTS,6,1780611,0.33761646259730044
112767,1601416,ls,codec,GI+STARTS,7,1714183,0.32502124310387176
106865,1128952,ls,codec,GI+STARTS,8,1235817,0.23431965991314668
108381,1146152,ls,codec,GI+STARTS,9,1254533,0.23786834613038957
105755,1460421,ls,codec,GI+STARTS,10,1566176,0.29695806716053624
105053,1637736,ls,codec,GI+STARTS,11,1742789,0.3304451433993649
110237,1141893,ls,codec,GI+STARTS,12,1252130,0.23741272030328792
109451,1116929,ls,codec,GI+STARTS,13,1226380,0.23253033784474952
106533,1435020,ls,codec,GI+STARTS,14,1541553,0.29228937188765897
104351,1127205,ls,codec,GI+STARTS,15,1231556,0.23351174412068718
104660,1184342,ls,codec,GI+STARTS,16,1289002,0.24440391276974333
105159,1934888,ls,codec,GI+STARTS,17,2040047,0.38680736650073205
106563,1166494,ls,codec,GI+STARTS,18,1273057,0.2413806277871649
109760,5284492,ls,codec,GI+STARTS,19,5394252,1.0227884016207993
104212,1138481,ls,codec,GI+STARTS,20,1242693,0.23562339823489076
67176,4110981,ls,codec,GI+Random,1,4178157,0.7922081726531786
62780,6354176,ls,codec,GI+Random,2,6416956,1.2167003266645677
64896,5203297,ls,codec,GI+Random,3,5268193,0.9988867219959103
65177,4578894,ls,codec,GI+Random,4,4644071,0.8805487684119145
64670,6142885,ls,codec,GI+Random,5,6207555,1.176996413297562
63089,5192643,ls,codec,GI+Random,6,5255732,0.9965240281001493
63017,7147369,ls,codec,GI+Random,7,7210386,1.3671402767258534
65529,5038605,ls,codec,GI+Random,8,5104134,0.9677799731118192
64817,5227618,ls,codec,GI+Random,9,5292435,1.00348317696911
61526,4646733,ls,codec,GI+Random,10,4708259,0.8927192680332218
61519,4106979,ls,codec,GI+Random,11,4168498,0.7903767578117409
63128,5647204,ls,codec,GI+Random,12,5710332,1.0827194092905008
60286,4850643,ls,codec,GI+Random,13,4910929,0.9311469361059198
60575,6242448,ls,codec,GI+Random,14,6303023,1.1950978225617075
63325,4316718,ls,codec,GI+Random,15,4380043,0.8304871887706341
62260,4979905,ls,codec,GI+Random,16,5042165,0.9560302116138322
64504,5693116,ls,codec,GI+Random,17,5757620,1.0916855491623207
62958,4072175,ls,codec,GI+Random,18,4135133,0.7840505173950755
60914,19045287,ls,codec,GI+Random,19,19106201,3.6226710917168345
61446,4479335,ls,codec,GI+Random,20,4540781,0.8609642525228882
184049,13526477,ls,compress,GI,1,13710526,1.4610654061704573
182684,8922636,ls,compress,GI,2,9105320,0.9703105529366262
183817,7030398,ls,compress,GI,3,7214215,0.7687845068216935
182434,13005367,ls,compress,GI,4,13187801,1.4053610944292119
182364,12308652,ls,compress,GI,5,12491016,1.3311080381249911
180698,8619432,ls,compress,GI,6,8800130,0.937787909289755
179352,11301968,ls,compress,GI,7,11481320,1.22350954800516
176950,8341487,ls,compress,GI,8,8518437,0.9077692289371285
180906,12703093,ls,compress,GI,9,12883999,1.372986363326598
180588,9080117,ls,compress,GI,10,9260705,0.9868691917618467
181119,6979289,ls,compress,GI,11,7160408,0.7630505512965872
171174,9578768,ls,compress,GI,12,9749942,1.0390048469598032
178701,8987123,ls,compress,GI,13,9165824,0.9767581758312501
170429,8632459,ls,compress,GI,14,8802888,0.9380818162040643
179119,16243425,ls,compress,GI,15,16422544,1.7500722379077365
181002,27909660,ls,compress,GI,16,28090662,2.993487958421656
178822,12989029,ls,compress,GI,17,13167851,1.4032351180185985
178288,9328854,ls,compress,GI,18,9507142,1.0131308082381532
179031,5982951,ls,compress,GI,19,6161982,0.6566530513595938
181008,6271187,ls,compress,GI,20,6452195,0.6875796675026177
224239,2416736,ls,compress,GI+Ekstazi,1,2640975,0.28143611784558986
227495,2287856,ls,compress,GI+Ekstazi,2,2515351,0.2680489669379764
224120,1702475,ls,compress,GI+Ekstazi,3,1926595,0.20530804625591845
223515,2100376,ls,compress,GI+Ekstazi,4,2323891,0.24764598731010543
225555,1705130,ls,compress,GI+Ekstazi,5,1930685,0.20574389806140256
226036,2017004,ls,compress,GI+Ekstazi,6,2243040,0.23903008160712308
225271,1792494,ls,compress,GI+Ekstazi,7,2017765,0.2150235986045709
224479,2261641,ls,compress,GI+Ekstazi,8,2486120,0.26493395859418506
225376,1841733,ls,compress,GI+Ekstazi,9,2067109,0.2202819534920548
225255,2386875,ls,compress,GI+Ekstazi,10,2612130,0.27836224368197376
224367,2016741,ls,compress,GI+Ekstazi,11,2241108,0.23882419757577947
225629,1827017,ls,compress,GI+Ekstazi,12,2052646,0.21874070051828534
224191,2210480,ls,compress,GI+Ekstazi,13,2434671,0.2594512838899422
225123,2041456,ls,compress,GI+Ekstazi,14,2266579,0.24153852064117956
225305,2515331,ls,compress,GI+Ekstazi,15,2740636,0.2920565155928648
222760,2069663,ls,compress,GI+Ekstazi,16,2292423,0.24429259253871793
224293,1823347,ls,compress,GI+Ekstazi,17,2047640,0.21820723495881014
223203,1906524,ls,compress,GI+Ekstazi,18,2129727,0.22695485529054024
224545,1563454,ls,compress,GI+Ekstazi,19,1787999,0.19053853113785507
223673,1947208,ls,compress,GI+Ekstazi,20,2170881,0.23134044091471972
294651,2978089,ls,compress,GI+STARTS,1,3272740,0.3487603026601826
299337,2151045,ls,compress,GI+STARTS,2,2450382,0.2611255302752628
298118,1968150,ls,compress,GI+STARTS,3,2266268,0.24150537885352538
299192,2592550,ls,compress,GI+STARTS,4,2891742,0.30815916178344804
300196,2149305,ls,compress,GI+STARTS,5,2449501,0.26103164630444825
298494,4052517,ls,compress,GI+STARTS,6,4351011,0.46366650367514184
295288,2553678,ls,compress,GI+STARTS,7,2848966,0.3036007273503455
290633,2327863,ls,compress,GI+STARTS,8,2618496,0.27904063795916495
296119,2132619,ls,compress,GI+STARTS,9,2428738,0.2588190323589062
303428,2642885,ls,compress,GI+STARTS,10,2946313,0.313974533147036
307606,2463376,ls,compress,GI+STARTS,11,2770982,0.2952903441721365
306447,1965854,ls,compress,GI+STARTS,12,2272301,0.2421482869079229
306927,2431326,ls,compress,GI+STARTS,13,2738253,0.29180257064116094
303106,2264671,ls,compress,GI+STARTS,14,2567777,0.27363575587546085
300813,2320295,ls,compress,GI+STARTS,15,2621108,0.2793189863493665
289762,2163495,ls,compress,GI+STARTS,16,2453257,0.2614319053219051
299046,2250676,ls,compress,GI+STARTS,17,2549722,0.2717117205825474
292858,2121234,ls,compress,GI+STARTS,18,2414092,0.2572582779473852
297796,1701338,ls,compress,GI+STARTS,19,1999134,0.21303818173709535
282629,2175280,ls,compress,GI+STARTS,20,2457909,0.26192764678868063
220411,12031288,ls,compress,GI+Random,1,12251699,1.3056051661120214
183305,9264078,ls,compress,GI+Random,2,9447383,1.0067625764425723
181687,7962718,ls,compress,GI+Random,3,8144405,0.867910421477754
178991,10286216,ls,compress,GI+Random,4,10465207,1.1152272287812235
181216,9075032,ls,compress,GI+Random,5,9256248,0.986394230515626
181749,8550440,ls,compress,GI+Random,6,8732189,0.9305477607527385
181162,11677055,ls,compress,GI+Random,7,11858217,1.2636736648588407
185378,9843984,ls,compress,GI+Random,8,10029362,1.0687813045364234
173830,10601537,ls,compress,GI+Random,9,10775367,1.1482795016391598
186105,12199766,ls,compress,GI+Random,10,12385871,1.3199032366365733
181309,9649228,ls,compress,GI+Random,11,9830537,1.04759347196298
185171,7476850,ls,compress,GI+Random,12,7662021,0.8165050578257591
187350,10025816,ls,compress,GI+Random,13,10213166,1.0883684207357402
179888,8797532,ls,compress,GI+Random,14,8977420,0.9566808595573056
185619,10216600,ls,compress,GI+Random,15,10402219,1.1085148978463006
189899,25644945,ls,compress,GI+Random,16,25834844,2.753096186259404
190014,8013916,ls,compress,GI+Random,17,8203930,0.8742537170086692
190624,30269022,ls,compress,GI+Random,18,30459646,3.245939291811149
190016,5837731,ls,compress,GI+Random,19,6027747,0.6423482672253242
189742,7875378,ls,compress,GI+Random,20,8065120,0.8594613969306122
23997,4602392,ls,csv,GI,1,4626389,1.0002337141656297
19268,3563455,ls,csv,GI,2,3582723,0.7745912272220574
19352,6388710,ls,csv,GI,3,6408062,1.3854346564596347
19186,4950667,ls,csv,GI,4,4969853,1.0744912555012553
19261,5096610,ls,csv,GI,5,5115871,1.1060606126121764
18898,3353786,ls,csv,GI,6,3372684,0.7291804134989497
19973,5330791,ls,csv,GI,7,5350764,1.1568449063284
19983,4707937,ls,csv,GI,8,4727920,1.0221849009838913
19102,3405802,ls,csv,GI,9,3424904,0.7404704724528616
19237,3917540,ls,csv,GI,10,3936777,0.8511383458139437
19398,6582400,ls,csv,GI,11,6601798,1.427320731938284
19301,4045786,ls,csv,GI,12,4065087,0.8788792011256331
19405,9647900,ls,csv,GI,13,9667305,2.0900889194838483
19286,3621002,ls,csv,GI,14,3640288,0.7870368848950168
19657,5199484,ls,csv,GI,15,5219141,1.1283877743925377
19394,4252773,ls,csv,GI,16,4272167,0.9236502736682617
19624,4254749,ls,csv,GI,17,4274373,0.924127214879528
19335,4604892,ls,csv,GI,18,4624227,0.9997662858343703
19178,6317936,ls,csv,GI,19,6337114,1.3700955698517807
19261,3721510,ls,csv,GI,20,3740771,0.808761492207654
25494,4952895,ls,csv,GI+Ekstazi,1,4978389,1.0763367542226376
25404,3630261,ls,csv,GI+Ekstazi,2,3655665,0.7903614202556889
25418,4521280,ls,csv,GI+Ekstazi,3,4546698,0.983004375059996
25555,3952586,ls,csv,GI+Ekstazi,4,3978141,0.8600813178279154
25696,3951926,ls,csv,GI+Ekstazi,5,3977622,0.859969109084195
25253,3856909,ls,csv,GI+Ekstazi,6,3882162,0.8393304835050984
25320,3927922,ls,csv,GI+Ekstazi,7,3953242,0.8546981087529738
24997,3440178,ls,csv,GI+Ekstazi,8,3465175,0.7491771358793836
25111,4591194,ls,csv,GI+Ekstazi,9,4616305,0.998053535029451
25521,5406851,ls,csv,GI+Ekstazi,10,5432372,1.174488704319799
25050,6295729,ls,csv,GI+Ekstazi,11,6320779,1.3665639131491352
25769,4442157,ls,csv,GI+Ekstazi,12,4467926,0.9659737254254204
25594,9794261,ls,csv,GI+Ekstazi,13,9819855,2.123070506872191
25546,5451690,ls,csv,GI+Ekstazi,14,5477236,1.1841883826979738
25515,5694656,ls,csv,GI+Ekstazi,15,5720171,1.2367113714373184
24849,4267946,ls,csv,GI+Ekstazi,16,4292795,0.928110084777057
25489,3741223,ls,csv,GI+Ekstazi,17,3766712,0.8143699835773098
25390,3816011,ls,csv,GI+Ekstazi,18,3841401,0.830517881187588
25345,10596318,ls,csv,GI+Ekstazi,19,10621663,2.296422854434775
25764,3813882,ls,csv,GI+Ekstazi,20,3839646,0.8301384469963946
37338,4560200,ls,csv,GI+STARTS,1,4597538,0.9939960755045935
38446,4690117,ls,csv,GI+STARTS,2,4728563,1.0223239187530864
38001,3723342,ls,csv,GI+STARTS,3,3761343,0.8132091960146222
38326,4116830,ls,csv,GI+STARTS,4,4155156,0.8983522827020385
38617,7039490,ls,csv,GI+STARTS,5,7078107,1.530299603831788
37793,4963398,ls,csv,GI+STARTS,6,5001191,1.0812665880845125
40549,4548217,ls,csv,GI+STARTS,7,4588766,0.9920995531540818
38952,4532894,ls,csv,GI+STARTS,8,4571846,0.9884414183877052
39855,3755232,ls,csv,GI+STARTS,9,3795087,0.8205047101728145
39418,5082724,ls,csv,GI+STARTS,10,5122142,1.10741641421501
39365,4676688,ls,csv,GI+STARTS,11,4716053,1.0196192340056056
38724,4173910,ls,csv,GI+STARTS,12,4212634,0.9107791308168018
40060,5549653,ls,csv,GI+STARTS,13,5589713,1.2085061146198264
37389,3783558,ls,csv,GI+STARTS,14,3820947,0.8260956891951844
35644,5871307,ls,csv,GI+STARTS,15,5906951,1.2770935470675682
37181,5235020,ls,csv,GI+STARTS,16,5272201,1.1398594428738584
38127,4324125,ls,csv,GI+STARTS,17,4362252,0.9431268144737605
38705,5545309,ls,csv,GI+STARTS,18,5584014,1.2072739804570853
38990,5114753,ls,csv,GI+STARTS,19,5153743,1.1142486078764917
38022,8175827,ls,csv,GI+STARTS,20,8213849,1.7758490894011816
23280,3583760,ls,csv,GI+Random,1,3607040,0.7798486068387229
23784,3437157,ls,csv,GI+Random,2,3460941,0.748261737380516
22767,3380471,ls,csv,GI+Random,3,3403238,0.7357862438566253
22836,3493319,ls,csv,GI+Random,4,3516155,0.7601991045785491
23209,4578509,ls,csv,GI+Random,5,4601718,0.9948997991052704
23984,2624850,ls,csv,GI+Random,6,2648834,0.5726827272908096
22880,3623713,ls,csv,GI+Random,7,3646593,0.7884000373596742
23459,2856519,ls,csv,GI+Random,8,2879978,0.6226564803900627
23025,3704084,ls,csv,GI+Random,9,3727109,0.8058077429654414
23358,3906416,ls,csv,GI+Random,10,3929774,0.8496242844800822
23699,3380258,ls,csv,GI+Random,11,3403957,0.7359416929640145
23344,3380981,ls,csv,GI+Random,12,3404325,0.736021255233165
24525,3323040,ls,csv,GI+Random,13,3347565,0.7237496400239725
23744,3595350,ls,csv,GI+Random,14,3619094,0.7824547035570388
24527,5673118,ls,csv,GI+Random,15,5697645,1.2318412092773066
22962,3875115,ls,csv,GI+Random,16,3898077,0.8427713354440396
22950,2981332,ls,csv,GI+Random,17,3004282,0.649531231217467
23638,3020355,ls,csv,GI+Random,18,3043993,0.6581168216257166
22942,2976345,ls,csv,GI+Random,19,2999287,0.6484513031348399
23727,3206745,ls,csv,GI+Random,20,3230472,0.6984339205086451
27216,1917396,ls,fileupload,GI,1,1944612,1.4204149607938381
20267,1103116,ls,fileupload,GI,2,1123383,0.8205595871574711
20201,1446571,ls,fileupload,GI,3,1466772,1.0713833365594265
20252,1219316,ls,fileupload,GI,4,1239568,0.9054253147266891
20308,1397932,ls,fileupload,GI,5,1418240,1.0359338078733715
19752,1200821,ls,fileupload,GI,6,1220573,0.8915506794882564
20244,1375626,ls,fileupload,GI,7,1395870,1.0195939505275575
19989,1433552,ls,fileupload,GI,8,1453541,1.0617189354623113
20011,2027270,ls,fileupload,GI,9,2047281,1.4954081129546508
20139,1280615,ls,fileupload,GI,10,1300754,0.9501177828340194
20278,1299465,ls,fileupload,GI,11,1319743,0.9639880354553721
20031,1515277,ls,fileupload,GI,12,1535308,1.1214445105894986
20138,1082955,ls,fileupload,GI,13,1103093,0.8057390370659839
20232,1255515,ls,fileupload,GI,14,1275747,0.9318517652816379
20374,1174110,ls,fileupload,GI,15,1194484,0.872494329989153
20248,1480241,ls,fileupload,GI,16,1500489,1.096011453239302
20451,1321769,ls,fileupload,GI,17,1342220,0.9804060494724425
20396,1928254,ls,fileupload,GI,18,1948650,1.4233644620885362
20115,1281568,ls,fileupload,GI,19,1301683,0.9507963580452067
19941,1412079,ls,fileupload,GI,20,1432020,1.0459992184332874
24410,1494183,ls,fileupload,GI+Ekstazi,1,1518593,1.1092352698413859
24705,1247514,ls,fileupload,GI+Ekstazi,2,1272219,0.9292747864387219
24479,1817535,ls,fileupload,GI+Ekstazi,3,1842014,1.3454736696018028
24690,1197227,ls,fileupload,GI+Ekstazi,4,1221917,0.8925323857141292
24512,1356156,ls,fileupload,GI+Ekstazi,5,1380668,1.0084898597197316
24808,1559092,ls,fileupload,GI+Ekstazi,6,1583900,1.1569378654463514
24512,1379836,ls,fileupload,GI+Ekstazi,7,1404348,1.0257865884612998
24957,1158691,ls,fileupload,GI+Ekstazi,8,1183648,0.8645793235430538
24899,1132176,ls,fileupload,GI+Ekstazi,9,1157075,0.8451694429328473
25408,1276772,ls,fileupload,GI+Ekstazi,10,1302180,0.9511593848266492
24562,1273544,ls,fileupload,GI+Ekstazi,11,1298106,0.9481835878294723
24764,1160651,ls,fileupload,GI+Ekstazi,12,1185415,0.8658700042730516
24966,1065068,ls,fileupload,GI+Ekstazi,13,1090034,0.7962002709918228
25382,1331146,ls,fileupload,GI+Ekstazi,14,1356528,0.9908571303353798
24970,1172384,ls,fileupload,GI+Ekstazi,15,1197354,0.8745906818256521
24431,1869878,ls,fileupload,GI+Ekstazi,16,1894309,1.3836718296330655
24995,1276293,ls,fileupload,GI+Ekstazi,17,1301288,0.9505078357541206
24710,1138013,ls,fileupload,GI+Ekstazi,18,1162723,0.8492949464772889
25268,1253821,ls,fileupload,GI+Ekstazi,19,1279089,0.9342928829950805
24731,1420795,ls,fileupload,GI+Ekstazi,20,1445526,1.055864489479893
39276,1931118,ls,fileupload,GI+STARTS,1,1970394,1.4392470663856922
40637,1081259,ls,fileupload,GI+STARTS,2,1121896,0.8194734285578633
38599,1235920,ls,fileupload,GI+STARTS,3,1274519,0.9309547896526411
40891,1253333,ls,fileupload,GI+STARTS,4,1294224,0.9453480345788488
38647,1375958,ls,fileupload,GI+STARTS,5,1414605,1.0332786723591993
39095,1243606,ls,fileupload,GI+STARTS,6,1282701,0.9369312184771136
39399,1352411,ls,fileupload,GI+STARTS,7,1391810,1.0166283796369002
42124,1330046,ls,fileupload,GI+STARTS,8,1372170,1.0022826130623903
39391,1136127,ls,fileupload,GI+STARTS,9,1175518,0.8586408773999393
39578,1284328,ls,fileupload,GI+STARTS,10,1323906,0.9670288412725659
40017,1308835,ls,fileupload,GI+STARTS,11,1348852,0.9852503022179695
40181,1150992,ls,fileupload,GI+STARTS,12,1191173,0.8700758557972893
38859,1067039,ls,fileupload,GI+STARTS,13,1105898,0.8077879105507854
40593,1414238,ls,fileupload,GI+STARTS,14,1454831,1.062661198134466
39144,1180015,ls,fileupload,GI+STARTS,15,1219159,0.8905178427297861
40377,1521807,ls,fileupload,GI+STARTS,16,1562184,1.1410757133622342
41732,1290451,ls,fileupload,GI+STARTS,17,1332183,0.9730746615341351
40388,1131650,ls,fileupload,GI+STARTS,18,1172038,0.8560989594936617
40005,1249418,ls,fileupload,GI+STARTS,19,1289423,0.9418412104788374
40553,1407241,ls,fileupload,GI+STARTS,20,1447794,1.0575211187360531
23291,2005672,ls,fileupload,GI+Random,1,2028963,1.4820279830100545
22822,1110305,ls,fileupload,GI+Random,2,1133127,0.8276769572950488
23049,1241411,ls,fileupload,GI+Random,3,1264460,0.9236073321183745
23996,1258436,ls,fileupload,GI+Random,4,1282432,0.9367347311447031
22458,1408435,ls,fileupload,GI+Random,5,1430893,1.045176016858467
22452,1230969,ls,fileupload,GI+Random,6,1253421,0.9155440471277423
22405,1381291,ls,fileupload,GI+Random,7,1403696,1.0253103440719626
24327,1249872,ls,fileupload,GI+Random,8,1274199,0.9307210500750523
22957,1111084,ls,fileupload,GI+Random,9,1134041,0.8283445759635366
22855,1290519,ls,fileupload,GI+Random,10,1313374,0.959335887425176
23034,1306615,ls,fileupload,GI+Random,11,1329649,0.9712237362541042
22554,1181646,ls,fileupload,GI+Random,12,1204200,0.8795912479136917
22398,1071350,ls,fileupload,GI+Random,13,1093748,0.7989131109642122
22921,1462250,ls,fileupload,GI+Random,14,1485171,1.0848226318346
23587,1565724,ls,fileupload,GI+Random,15,1589311,1.1608902556161411
22479,1511921,ls,fileupload,GI+Random,16,1534400,1.1207812745380905
22615,1325870,ls,fileupload,GI+Random,17,1348485,0.9849822321399223
22455,1126072,ls,fileupload,GI+Random,18,1148527,0.8389256744665077
22645,1240330,ls,fileupload,GI+Random,19,1262975,0.9225226343911267
23621,1702141,ls,fileupload,GI+Random,20,1725762,1.2605590028085272
205478,6996680,ls,imaging,GI,1,7202158,1.153337519334634
185251,5487379,ls,imaging,GI,2,5672630,0.9084023166810871
182268,4458191,ls,imaging,GI,3,4640459,0.7431127547651796
190862,4275027,ls,imaging,GI,4,4465889,0.7151575043041029
190274,6458121,ls,imaging,GI,5,6648395,1.0646591475578269
184891,7100852,ls,imaging,GI,6,7285743,1.166722634817186
179316,5172799,ls,imaging,GI,7,5352115,0.8570757594173419
189010,7658146,ls,imaging,GI,8,7847156,1.2566260605323973
186173,7379030,ls,imaging,GI,9,7565203,1.2114747359448281
177473,4840705,ls,imaging,GI,10,5018178,0.8035998330083337
179016,5034334,ls,imaging,GI,11,5213350,0.8348542418013065
184575,7762858,ls,imaging,GI,12,7947433,1.2726841956672164
184566,7731469,ls,imaging,GI,13,7916035,1.2676561899733578
179613,9249917,ls,imaging,GI,14,9429530,1.510023903764887
178275,5825207,ls,imaging,GI,15,6003482,0.9613842180704905
176431,3833305,ls,imaging,GI,16,4009736,0.6421101802302557
179965,6305799,ls,imaging,GI,17,6485764,1.0386157819295097
180818,9777466,ls,imaging,GI,18,9958284,1.5946973900586152
184942,4155587,ls,imaging,GI,19,4340529,0.6950826334912452
186779,4648669,ls,imaging,GI,20,4835448,0.7743378583462924
226191,4959022,ls,imaging,GI+Ekstazi,1,5185213,0.8303484453745246
222983,6294605,ls,imaging,GI+Ekstazi,2,6517588,1.0437120063132714
230751,3578428,ls,imaging,GI+Ekstazi,3,3809179,0.6099934295473082
228295,3951966,ls,imaging,GI+Ekstazi,4,4180261,0.6694176734127905
228169,4444843,ls,imaging,GI+Ekstazi,5,4673012,0.7483257195830717
226611,5528102,ls,imaging,GI+Ekstazi,6,5754713,0.9215469052335105
226442,4383167,ls,imaging,GI+Ekstazi,7,4609609,0.7381725045691309
230923,5384702,ls,imaging,GI+Ekstazi,8,5615625,0.8992736631178535
230359,5212861,ls,imaging,GI+Ekstazi,9,5443220,0.8716651109282337
224340,6504241,ls,imaging,GI+Ekstazi,10,6728581,1.07749995476108
227970,4659975,ls,imaging,GI+Ekstazi,11,4887945,0.7827446108436009
225930,6392002,ls,imaging,GI+Ekstazi,12,6617932,1.0597808706786622
233018,5751178,ls,imaging,GI+Ekstazi,13,5984196,0.9582958010435538
228517,7098346,ls,imaging,GI+Ekstazi,14,7326863,1.173307499908321
229313,5144858,ls,imaging,GI+Ekstazi,15,5374171,0.8606077580664196
225756,3521659,ls,imaging,GI+Ekstazi,16,3747415,0.6001026803379483
228879,5890745,ls,imaging,GI+Ekstazi,17,6119624,0.9799829389220134
237089,7738872,ls,imaging,GI+Ekstazi,18,7975961,1.277252605961961
236390,3889833,ls,imaging,GI+Ekstazi,19,4126223,0.6607641486123341
226998,3470135,ls,imaging,GI+Ekstazi,20,3697133,0.592050633000583
315545,5935218,ls,imaging,GI+STARTS,1,6250763,1.0009832459061179
321234,4595778,ls,imaging,GI+STARTS,2,4917012,0.7873993353962281
316790,4867716,ls,imaging,GI+STARTS,3,5184506,0.8302352279713283
319331,3826457,ls,imaging,GI+STARTS,4,4145788,0.6638972440770243
319206,5629296,ls,imaging,GI+STARTS,5,5948502,0.9525798434909521
322783,6582285,ls,imaging,GI+STARTS,6,6905068,1.1057621893267215
308988,4953966,ls,imaging,GI+STARTS,7,5262954,0.8427977157307975
317264,4711038,ls,imaging,GI+STARTS,8,5028302,0.8052210677890402
318621,7091464,ls,imaging,GI+STARTS,9,7410085,1.1866344853804625
309010,5678476,ls,imaging,GI+STARTS,10,5987486,0.9588226543059525
300071,5755714,ls,imaging,GI+STARTS,11,6055785,0.9697599038404721
317089,8603291,ls,imaging,GI+STARTS,12,8920380,1.4284897583088683
302758,5375856,ls,imaging,GI+STARTS,13,5678614,0.9093605810951277
303820,5794214,ls,imaging,GI+STARTS,14,6098034,0.9765255644736279
306897,4579675,ls,imaging,GI+STARTS,15,4886572,0.7825247416857671
304047,7933832,ls,imaging,GI+STARTS,16,8237879,1.319195570333069
293171,6540671,ls,imaging,GI+STARTS,17,6833842,1.0943562165402139
312199,6018240,ls,imaging,GI+STARTS,18,6330439,1.0137423828468108
314554,4049628,ls,imaging,GI+STARTS,19,4364182,0.6988703721585755
309361,5425085,ls,imaging,GI+STARTS,20,5734446,0.9183013930544727
200425,1392052,ls,imaging,GI+Random,1,1592477,0.25501571512003207
192558,1502843,ls,imaging,GI+Random,2,1695401,0.2714977349313161
190842,844631,ls,imaging,GI+Random,3,1035473,0.1658183368315429
193372,845556,ls,imaging,GI+Random,4,1038928,0.16637161282594642
190086,1264428,ls,imaging,GI+Random,5,1454514,0.23292262799531693
191196,1496948,ls,imaging,GI+Random,6,1688144,0.2703356151364142
186926,912673,ls,imaging,GI+Random,7,1099599,0.17608733145299565
181769,1243968,ls,imaging,GI+Random,8,1425737,0.22831434339591036
190860,1441515,ls,imaging,GI+Random,9,1632375,0.261404891856562
182221,1191349,ls,imaging,GI+Random,10,1373570,0.21996043636261148
179452,1034740,ls,imaging,GI+Random,11,1214192,0.19443799889921298
190857,1165484,ls,imaging,GI+Random,12,1356341,0.21720142272800136
179728,1040601,ls,imaging,GI+Random,13,1220329,0.19542076439202175
181741,1214245,ls,imaging,GI+Random,14,1395986,0.22355008460879064
181842,1130697,ls,imaging,GI+Random,15,1312539,0.2101870681384609
188266,895224,ls,imaging,GI+Random,16,1083490,0.17350767212047868
181996,1313624,ls,imaging,GI+Random,17,1495620,0.23950525115767596
189261,1480371,ls,imaging,GI+Random,18,1669632,0.2673711447432455
189776,814674,ls,imaging,GI+Random,19,1004450,0.16085038280133165
184211,837395,ls,imaging,GI+Random,20,1021606,0.16359770637875176
45067,4102727,ls,text,GI,1,4147794,1.8797443185101244
43760,2074622,ls,text,GI,2,2118382,0.9600323759892884
43652,1505002,ls,text,GI,3,1548654,0.7018365805625781
42617,1911359,ls,text,GI,4,1953976,0.8855250006401327
42542,1950309,ls,text,GI,5,1992851,0.9031428139601967
42579,2486738,ls,text,GI,6,2529317,1.1462645590550236
42642,2811253,ls,text,GI,7,2853895,1.2933604976222184
42380,2252385,ls,text,GI,8,2294765,1.0399676240107116
43919,1157565,ls,text,GI,9,1201484,0.544502143255142
43570,1603218,ls,text,GI,10,1646788,0.7463100594655016
42471,2300194,ls,text,GI,11,2342665,1.061675489169067
42818,1514489,ls,text,GI,12,1557307,0.7057580452226042
42177,2463948,ls,text,GI,13,2506125,1.1357541455111284
40641,2367285,ls,text,GI,14,2407926,1.0912512091711426
40228,1994197,ls,text,GI,15,2034425,0.9219837907053628
43554,2939811,ls,text,GI,16,2983365,1.3520351803372967
42144,10614265,ls,text,GI,17,10656409,4.829392268147878
44084,1410623,ls,text,GI,18,1454707,0.6592606137978182
42220,1720612,ls,text,GI,19,1762832,0.7989001952574886
41713,2468201,ls,text,GI,20,2509914,1.1374712874962016
55733,1394745,ls,text,GI+Ekstazi,1,1450478,0.6573440676233989
57194,1494979,ls,text,GI+Ekstazi,2,1552173,0.7034313608860072
57343,1043258,ls,text,GI+Ekstazi,3,1100601,0.49878284136014506
57224,1385745,ls,text,GI+Ekstazi,4,1442969,0.6539410538556726
56936,2336791,ls,text,GI+Ekstazi,5,2393727,1.0848163453426771
55361,1830744,ls,text,GI+Ekstazi,6,1886105,0.8547664512421634
57214,2244404,ls,text,GI+Ekstazi,7,2301618,1.0430733442597766
56935,1521320,ls,text,GI+Ekstazi,8,1578255,0.7152514974008344
56567,980744,ls,text,GI+Ekstazi,9,1037311,0.4701003614880719
55922,1258966,ls,text,GI+Ekstazi,10,1314888,0.5958958539110526
57876,2077589,ls,text,GI+Ekstazi,11,2135465,0.9677742436406491
55759,745993,ls,text,GI+Ekstazi,12,801752,0.36334706276496115
55354,1716169,ls,text,GI+Ekstazi,13,1771523,0.8028388811884127
57767,2942232,ls,text,GI+Ekstazi,14,2999999,1.3595735650772567
55093,1834441,ls,text,GI+Ekstazi,15,1889534,0.8563204443450445
56226,1934948,ls,text,GI+Ekstazi,16,1991174,0.9023828120839845
56751,7190865,ls,text,GI+Ekstazi,17,7247616,3.2845568026625895
56326,2498145,ls,text,GI+Ekstazi,18,2554471,1.1576641340068663
57514,1874751,ls,text,GI+Ekstazi,19,1932265,0.8756857634699229
56139,1990595,ls,text,GI+Ekstazi,20,2046734,0.9275621229023189
83978,3351022,ls,text,GI+STARTS,1,3435000,1.5567122509175426
84469,1885315,ls,text,GI+STARTS,2,1969784,0.8926890493337294
84960,2205539,ls,text,GI+STARTS,3,2290499,1.0380343097567337
85866,2066571,ls,text,GI+STARTS,4,2152437,0.9754658070533341
85037,2128205,ls,text,GI+STARTS,5,2213242,1.0030221064469413
81551,2858803,ls,text,GI+STARTS,6,2940354,1.33254296763738
79690,2218147,ls,text,GI+STARTS,7,2297837,1.0413598278054186
80751,1935117,ls,text,GI+STARTS,8,2015868,0.9135739190196928
83373,1538711,ls,text,GI+STARTS,9,1622084,0.7351144206163991
84619,1878855,ls,text,GI+STARTS,10,1963474,0.8898294119819712
84523,2123134,ls,text,GI+STARTS,11,2207657,1.0004910328162646
86639,2544217,ls,text,GI+STARTS,12,2630856,1.1922811544686818
87511,1589035,ls,text,GI+STARTS,13,1676546,0.7597961273440472
87015,3266679,ls,text,GI+STARTS,14,3353694,1.519865075874427
87655,1922319,ls,text,GI+STARTS,15,2009974,0.9109028092651343
87088,2398644,ls,text,GI+STARTS,16,2485732,1.126512214526278
85850,6735115,ls,text,GI+STARTS,17,6820965,3.0912022645064847
85807,1471961,ls,text,GI+STARTS,18,1557768,0.7059669664300782
84819,1729136,ls,text,GI+STARTS,19,1813955,0.8220686961028038
84672,1895761,ls,text,GI+STARTS,20,1980433,0.8975150839072435
43245,2267515,ls,text,GI+Random,1,2310760,1.0472164194847804
39324,3969416,ls,text,GI+Random,2,4008740,1.8167262499980172
41960,2404210,ls,text,GI+Random,3,2446170,1.1085830587560306
41372,2163995,ls,text,GI+Random,4,2205367,0.9994532246489863
42517,3526237,ls,text,GI+Random,5,3568754,1.6173284053307084
40459,4075981,ls,text,GI+Random,6,4116440,1.86553495725386
41064,2843614,ls,text,GI+Random,7,2884678,1.3073110866236723
42270,2929663,ls,text,GI+Random,8,2971933,1.3468542969450146
40618,2108419,ls,text,GI+Random,9,2149037,0.9739249564992963
40574,1827738,ls,text,GI+Random,10,1868312,0.8467028177398124
40860,2117702,ls,text,GI+Random,11,2158562,0.9782416040072991
42769,2663945,ls,text,GI+Random,12,2706714,1.2266593430946215
42041,2304483,ls,text,GI+Random,13,2346524,1.0634243545478996
42593,4210330,ls,text,GI+Random,14,4252923,1.927387870832311
39856,2134350,ls,text,GI+Random,15,2174206,0.9853313293212304
42498,2471382,ls,text,GI+Random,16,2513880,1.1392686443483528
39590,2866767,ls,text,GI+Random,17,2906357,1.3171358216710207
39628,1629767,ls,text,GI+Random,18,1669395,0.7565553560758344
39340,4331651,ls,text,GI+Random,19,4370991,1.9808952658952896
41701,3677406,ls,text,GI+Random,20,3719107,1.6854670827869545
86021,5579453,ls,validator,GI,1,5665474,2.7260476722511084
83006,4253118,ls,validator,GI,2,4336124,2.086406316010305
84733,2880922,ls,validator,GI,3,2965655,1.426979791884997
82723,4953722,ls,validator,GI,4,5036445,2.4233787267703875
83462,808416,ls,validator,GI,5,891878,0.42914360666591606
88564,4644634,ls,validator,GI,6,4733198,2.2774658201950273
85366,933303,ls,validator,GI,7,1018669,0.4901514429762389
84793,787561,ls,validator,GI,8,872354,0.4197492727138
87844,4192839,ls,validator,GI,9,4280683,2.059729852752813
85616,812891,ls,validator,GI,10,898507,0.43233327270610133
85637,4307387,ls,validator,GI,11,4393024,2.1137848041211122
86104,4787662,ls,validator,GI,12,4873766,2.3451027150414236
85031,732858,ls,validator,GI,13,817889,0.39354242992021266
83688,692987,ls,validator,GI,14,776675,0.37371155102743914
87070,4189603,ls,validator,GI,15,4276673,2.057800367035338
87645,2985276,ls,validator,GI,16,3072921,1.4785928130746957
88195,1102698,ls,validator,GI,17,1190893,0.5730202081150031
84943,1102673,ls,validator,GI,18,1187616,0.5714434189139642
85438,848882,ls,validator,GI,19,934320,0.4495653604866346
86594,888914,ls,validator,GI,20,975508,0.4693837289981975
96267,2580284,ls,validator,GI+Ekstazi,1,2676551,1.2878720515196744
98959,2709291,ls,validator,GI+Ekstazi,2,2808250,1.3512414628677452
96413,641478,ls,validator,GI+Ekstazi,3,737891,0.35504991160934507
96655,3485878,ls,validator,GI+Ekstazi,4,3582533,1.7238020588238125
97697,2459633,ls,validator,GI+Ekstazi,5,2557330,1.2305066608156576
96916,2863421,ls,validator,GI+Ekstazi,6,2960337,1.4244209377589288
97409,664746,ls,validator,GI+Ekstazi,7,762155,0.36672498428984823
98400,578200,ls,validator,GI+Ekstazi,8,676600,0.325558612579477
95688,2771562,ls,validator,GI+Ekstazi,9,2867250,1.3796304048455594
95082,543798,ls,validator,GI+Ekstazi,10,638880,0.3074089364539998
97877,769559,ls,validator,GI+Ekstazi,11,867436,0.41738288599097134
96042,1572598,ls,validator,GI+Ekstazi,12,1668640,0.8028970193535597
96422,4302872,ls,validator,GI+Ekstazi,13,4399294,2.11680173066689
97865,517151,ls,validator,GI+Ekstazi,14,615016,0.29592633117673606
97443,517329,ls,validator,GI+Ekstazi,15,614772,0.29580892606076004
96102,518420,ls,validator,GI+Ekstazi,16,614522,0.2956886339337354
98542,2666082,ls,validator,GI+Ekstazi,17,2764624,1.3302500055334379
96272,4164911,ls,validator,GI+Ekstazi,18,4261183,2.0503470668448913
98287,584263,ls,validator,GI+Ekstazi,19,682550,0.32842156520266336
95964,620031,ls,validator,GI+Ekstazi,20,715995,0.34451424595601926
161010,2747061,ls,validator,GI+STARTS,1,2908071,1.39927218451465
157261,2162330,ls,validator,GI+STARTS,2,2319591,1.116114140868817
158347,690554,ls,validator,GI+STARTS,3,848901,0.4084644276933648
160628,2106509,ls,validator,GI+STARTS,4,2267137,1.0908749279450158
159334,2177417,ls,validator,GI+STARTS,5,2336751,1.1243709924677883
160585,3068216,ls,validator,GI+STARTS,6,3228801,1.5535973601170971
160179,707691,ls,validator,GI+STARTS,7,867870,0.41759171312348614
160338,605888,ls,validator,GI+STARTS,8,766226,0.3686838212863174
160609,724104,ls,validator,GI+STARTS,9,884713,0.42569603430538994
157425,1711978,ls,validator,GI+STARTS,10,1869403,0.8994978525449484
160355,2868020,ls,validator,GI+STARTS,11,3028375,1.4571586807129377
159659,5034958,ls,validator,GI+STARTS,12,5194617,2.4994861120333507
163124,502480,ls,validator,GI+STARTS,13,665604,0.3202676836644254
160741,508850,ls,validator,GI+STARTS,14,669591,0.32218610250621427
159993,2358894,ls,validator,GI+STARTS,15,2518887,1.212009099858825
159214,522596,ls,validator,GI+STARTS,16,681810,0.32806550050667044
159848,2862158,ls,validator,GI+STARTS,17,3022006,1.4540941184848581
160189,780251,ls,validator,GI+STARTS,18,940440,0.4525101117561977
156303,1633997,ls,validator,GI+STARTS,19,1790300,0.8614359800488289
155685,2571324,ls,validator,GI+STARTS,20,2727009,1.312150852101311
89042,1020211,ls,validator,GI+Random,1,1109253,0.5337376111138378
84546,3810850,ls,validator,GI+Random,2,3895396,1.8743418817730482
84916,775456,ls,validator,GI+Random,3,860372,0.4139839116497632
82792,798649,ls,validator,GI+Random,4,881441,0.4241216509468915
82333,724022,ls,validator,GI+Random,5,806355,0.387992632347804
82582,1883398,ls,validator,GI+Random,6,1965980,0.9459676635515818
86822,828798,ls,validator,GI+Random,7,915620,0.44056750938519174
83085,656551,ls,validator,GI+Random,8,739636,0.35588955065597705
85235,3289913,ls,validator,GI+Random,9,3375148,1.6240149277717952
78711,3343624,ls,validator,GI+Random,10,3422335,1.6467198261634415
84532,3658883,ls,validator,GI+Random,11,3743415,1.801213410743723
84239,866011,ls,validator,GI+Random,12,950250,0.45723037482064444
81706,3138572,ls,validator,GI+Random,13,3220278,1.5494963609225731
86561,651001,ls,validator,GI+Random,14,737562,0.35489160717018065
86462,638139,ls,validator,GI+Random,15,724601,0.34865518213671537
84119,2494382,ls,validator,GI+Random,16,2578501,1.240693479300612
81898,994846,ls,validator,GI+Random,17,1076744,0.518095304084062
87487,4059432,ls,validator,GI+Random,18,4146919,1.995366828435519
86182,722185,ls,validator,GI+Random,19,808367,0.38896074338609826
83574,761315,ls,validator,GI+Random,20,844889,0.4065339796388734
18727,1371193,ls,gson,GI,1,1389920,1.2447620710809009
7047,1135630,ls,gson,GI,2,1142677,1.0233401843965915
6154,1646617,ls,gson,GI,3,1652771,1.4801619179394867
6449,1058992,ls,gson,GI,4,1065441,0.9541704168401821
6403,1054969,ls,gson,GI,5,1061372,0.9505263676379057
6329,1076506,ls,gson,GI,6,1082835,0.9697478540051853
6320,1758548,ls,gson,GI,7,1764868,1.580551935985098
6696,1403644,ls,gson,GI,8,1410340,1.263049484379128
5993,930584,ls,gson,GI,9,936577,0.8387644801475889
6627,691635,ls,gson,GI,10,698262,0.6253381872892626
6185,1647358,ls,gson,GI,11,1653543,1.480853293212074
6224,1647960,ls,gson,GI,12,1654184,1.4814273496236392
6390,728739,ls,gson,GI,13,735129,0.6583549388106017
6666,1306808,ls,gson,GI,14,1313474,1.1762997989459214
6487,1590463,ls,gson,GI,15,1596950,1.4301706496867765
6601,956130,ls,gson,GI,16,962731,0.8621870564160431
5988,1083768,ls,gson,GI,17,1089756,0.9759460512352064
6344,1205350,ls,gson,GI,18,1211694,1.0851493128786556
6516,978429,ls,gson,GI,19,984945,0.8820811112155935
6583,1083970,ls,gson,GI,20,1090553,0.9766598156034085
7865,845494,ls,gson,GI+Ekstazi,1,853359,0.7642374497924531
8146,1008474,ls,gson,GI+Ekstazi,2,1016620,0.910448095359636
7677,1373262,ls,gson,GI+Ekstazi,3,1380939,1.2367190123722143
8303,672107,ls,gson,GI+Ekstazi,4,680410,0.6093505818925951
7585,975974,ls,gson,GI+Ekstazi,5,983559,0.880839859754705
7751,698829,ls,gson,GI+Ekstazi,6,706580,0.6327874871822428
7815,943846,ls,gson,GI+Ekstazi,7,951661,0.8522731648777779
7859,1148347,ls,gson,GI+Ekstazi,8,1156206,1.0354562673795356
7474,912132,ls,gson,GI+Ekstazi,9,919606,0.8235658664803894
7648,619051,ls,gson,GI+Ekstazi,10,626699,0.56124895330978
7332,1123916,ls,gson,GI+Ekstazi,11,1131248,1.0131047854452968
8799,919060,ls,gson,GI+Ekstazi,12,927859,0.8309569547247708
8336,672625,ls,gson,GI+Ekstazi,13,680961,0.6098440375599468
8694,544805,ls,gson,GI+Ekstazi,14,553499,0.4956936813494356
7821,820725,ls,gson,GI+Ekstazi,15,828546,0.7420158246127806
8552,1014948,ls,gson,GI+Ekstazi,16,1023500,0.9166095744728487
7629,1241563,ls,gson,GI+Ekstazi,17,1249192,1.118731165173314
8538,1145441,ls,gson,GI+Ekstazi,18,1153979,1.0334618467421628
7914,1064332,ls,gson,GI+Ekstazi,19,1072246,0.9602647286665502
8369,998385,ls,gson,GI+Ekstazi,20,1006754,0.9016124626661831
64312,1327792,ls,gson,GI+STARTS,1,1392104,1.246717982473816
28566,965413,ls,gson,GI+STARTS,2,993979,0.8901716348069836
30912,1191063,ls,gson,GI+STARTS,3,1221975,1.0943566045593154
28642,921998,ls,gson,GI+STARTS,4,950640,0.8513587942128665
25036,1678887,ls,gson,GI+STARTS,5,1703923,1.5259717986951635
28718,1083031,ls,gson,GI+STARTS,6,1111749,0.9956421864295214
24287,1690085,ls,gson,GI+STARTS,7,1714372,1.5353295450983553
31066,1032664,ls,gson,GI+STARTS,8,1063730,0.9526381071363004
22244,1190427,ls,gson,GI+STARTS,9,1212671,1.0860242787352847
22228,1068756,ls,gson,GI+STARTS,10,1090984,0.9770458036118089
22443,1530607,ls,gson,GI+STARTS,11,1553050,1.3908553977870617
20868,1096531,ls,gson,GI+STARTS,12,1117399,1.0007021220384824
21740,780280,ls,gson,GI+STARTS,13,802020,0.7182600986015771
23801,628434,ls,gson,GI+STARTS,14,652235,0.5841180711346345
23033,942122,ls,gson,GI+STARTS,15,965155,0.8643579031268611
27944,1124385,ls,gson,GI+STARTS,16,1152329,1.0319841664315812
19639,1529286,ls,gson,GI+STARTS,17,1548925,1.387161197010608
28155,1482794,ls,gson,GI+STARTS,18,1510949,1.3531512652077933
22371,1375045,ls,gson,GI+STARTS,19,1397416,1.2514752175100639
32603,1199156,ls,gson,GI+STARTS,20,1231759,1.1031188010191517
7158,921620,ls,gson,GI+Random,1,928778,0.8317799778795736
6858,579028,ls,gson,GI+Random,2,585886,0.5246983069365896
6508,664261,ls,gson,GI+Random,3,670769,0.6007164510596759
6343,787664,ls,gson,GI+Random,4,794007,0.7110839456750984
7159,688388,ls,gson,GI+Random,5,695547,0.6229067315054876
6283,843334,ls,gson,GI+Random,6,849617,0.7608862499608191
6259,1333356,ls,gson,GI+Random,7,1339615,1.199710732884656
6848,1012105,ls,gson,GI+Random,8,1018953,0.9125374457624159
6981,664429,ls,gson,GI+Random,9,671410,0.6012905074712412
6769,815858,ls,gson,GI+Random,10,822627,0.7367149823350035
6293,850702,ls,gson,GI+Random,11,856995,0.76749371985868
6661,694324,ls,gson,GI+Random,12,700985,0.6277768075836345
7052,680904,ls,gson,GI+Random,13,687956,0.6161085065129879
6619,650824,ls,gson,GI+Random,14,657443,0.5887821675331246
6153,776303,ls,gson,GI+Random,15,782456,0.7007392879372031
7007,690097,ls,gson,GI+Random,16,697104,0.6243011243803818
6537,926240,ls,gson,GI+Random,17,932777,0.8353613376141285
6817,955092,ls,gson,GI+Random,18,961909,0.8614509029522261
6437,569254,ls,gson,GI+Random,19,575691,0.515568033744845
6901,781589,ls,gson,GI+Random,20,788490,0.7061431200548085
45893,12332511,ls,jcodec,GI,1,12378404,1.0583697789799642
26179,21930510,ls,jcodec,GI,2,21956689,1.8773257104923875
25687,15398759,ls,jcodec,GI,3,15424446,1.3188103655292227
23865,8061933,ls,jcodec,GI,4,8085798,0.6913463352898028
24810,9696359,ls,jcodec,GI,5,9721169,0.8311727009359914
26005,9092002,ls,jcodec,GI,6,9118007,0.7796015587573136
26736,15031475,ls,jcodec,GI,7,15058211,1.2874967926320442
25997,9341473,ls,jcodec,GI,8,9367470,0.8009309724825143
24558,7757783,ls,jcodec,GI,9,7782341,0.6654003637396804
23894,10136331,ls,jcodec,GI,10,10160225,0.8687125648538137
24858,10988192,ls,jcodec,GI,11,11013050,0.9416302210200358
25393,12364597,ls,jcodec,GI,12,12389990,1.0593603971775334
24199,13375902,ls,jcodec,GI,13,13400101,1.1457262126586916
24849,13906131,ls,jcodec,GI,14,13930980,1.19111706352243
25123,9425250,ls,jcodec,GI,15,9450373,0.8080192877279027
25618,8208464,ls,jcodec,GI,16,8234082,0.7040248117966502
24710,16064838,ls,jcodec,GI,17,16089548,1.3756774589557366
25959,8863862,ls,jcodec,GI,18,8889821,0.7600913564415448
24882,14375296,ls,jcodec,GI,19,14400178,1.2312341079780675
24923,18411814,ls,jcodec,GI,20,18436737,1.5763651973066746
32841,2333805,ls,jcodec,GI+Ekstazi,1,2366646,0.2023513373730423
45606,3196541,ls,jcodec,GI+Ekstazi,2,3242147,0.27720782128379023
44842,3235382,ls,jcodec,GI+Ekstazi,3,3280224,0.28046345473009077
44946,3135198,ls,jcodec,GI+Ekstazi,4,3180144,0.2719064834533159
47259,2590725,ls,jcodec,GI+Ekstazi,5,2637984,0.2255510922920824
43657,2334592,ls,jcodec,GI+Ekstazi,6,2378249,0.2033434090929106
40686,2492058,ls,jcodec,GI+Ekstazi,7,2532744,0.21655293424684074
45788,2795308,ls,jcodec,GI+Ekstazi,8,2841096,0.24291743471782473
32288,2249426,ls,jcodec,GI+Ekstazi,9,2281714,0.1950895399661774
45900,1953418,ls,jcodec,GI+Ekstazi,10,1999318,0.17094431154215553
30727,2302954,ls,jcodec,GI+Ekstazi,11,2333681,0.1995327866322461
44456,2633853,ls,jcodec,GI+Ekstazi,12,2678309,0.22899893268712582
47485,1081733,ls,jcodec,GI+Ekstazi,13,1129218,0.09654962021599854
44026,2804726,ls,jcodec,GI+Ekstazi,14,2848752,0.2435720327603406
45510,2867481,ls,jcodec,GI+Ekstazi,15,2912991,0.2490645515238172
34609,1435599,ls,jcodec,GI+Ekstazi,16,1470208,0.1257047124988468
47877,1324977,ls,jcodec,GI+Ekstazi,17,1372854,0.11738081779781624
49577,1063660,ls,jcodec,GI+Ekstazi,18,1113237,0.0951832237534272
47236,960682,ls,jcodec,GI+Ekstazi,19,1007918,0.08617831110455981
41314,1801409,ls,jcodec,GI+Ekstazi,20,1842723,0.1575552336336168
102581,13176832,ls,jcodec,GI+STARTS,1,13279413,1.1354072303500244
46376,12037181,ls,jcodec,GI+STARTS,2,12083557,1.033159973723737
42440,12303029,ls,jcodec,GI+STARTS,3,12345469,1.0555537932785195
46635,6636583,ls,jcodec,GI+STARTS,4,6683218,0.5714239054998462
44447,6908398,ls,jcodec,GI+STARTS,5,6952845,0.5944773676745362
46871,8684381,ls,jcodec,GI+STARTS,6,8731252,0.746533498943674
43697,14503582,ls,jcodec,GI+STARTS,7,14547279,1.243811436433152
41496,12015558,ls,jcodec,GI+STARTS,8,12057054,1.0308939324592648
48294,13946202,ls,jcodec,GI+STARTS,9,13994496,1.1965477648375342
50179,8851573,ls,jcodec,GI+STARTS,10,8901752,0.7611114725916568
43606,11971918,ls,jcodec,GI+STARTS,11,12015524,1.0273430629836007
41762,8869961,ls,jcodec,GI+STARTS,12,8911723,0.7619640061708006
41137,13034572,ls,jcodec,GI+STARTS,13,13075709,1.1179902711477447
51050,11486689,ls,jcodec,GI+STARTS,14,11537739,0.9864918187642375
39504,12080374,ls,jcodec,GI+STARTS,15,12119878,1.03626546686666
43116,9145572,ls,jcodec,GI+STARTS,16,9188688,0.78564487697088
40056,13025421,ls,jcodec,GI+STARTS,17,13065477,1.1171154217262425
40992,6766913,ls,jcodec,GI+STARTS,18,6807905,0.5820848075540751
41958,15960150,ls,jcodec,GI+STARTS,19,16002108,1.368201224259082
40297,13757021,ls,jcodec,GI+STARTS,20,13797318,1.1796887871955288
25474,9530688,ls,jcodec,GI+Random,1,9556162,0.8170643859932777
25896,12822901,ls,jcodec,GI+Random,2,12848797,1.0985889975031051
24481,12582325,ls,jcodec,GI+Random,3,12606806,1.0778984495790642
25500,12082793,ls,jcodec,GI+Random,4,12108293,1.0352749341704026
27715,13680992,ls,jcodec,GI+Random,5,13708707,1.1721124304628519
25124,11899401,ls,jcodec,GI+Random,6,11924525,1.0195625291185404
25484,15030819,ls,jcodec,GI+Random,7,15056303,1.2873336561292854
25591,10522459,ls,jcodec,GI+Random,8,10548050,0.901872111070992
24933,19695709,ls,jcodec,GI+Random,9,19720642,1.6861407589284532
25422,19957437,ls,jcodec,GI+Random,10,19982859,1.70856065638331
24554,12626849,ls,jcodec,GI+Random,11,12651403,1.0817115515777684
24212,11072129,ls,jcodec,GI+Random,12,11096341,0.9487517107743708
24405,11934467,ls,jcodec,GI+Random,13,11958872,1.0224992426721315
25849,8887670,ls,jcodec,GI+Random,14,8913519,0.7621175665266469
24794,10306900,ls,jcodec,GI+Random,15,10331694,0.8833733892728516
24623,14292359,ls,jcodec,GI+Random,16,14316982,1.2241207408483457
24684,14978197,ls,jcodec,GI+Random,17,15002881,1.2827660050546665
25198,13265268,ls,jcodec,GI+Random,18,13290466,1.1363522763484477
25182,15995825,ls,jcodec,GI+Random,19,16021007,1.3698171135492476
25215,20476275,ls,jcodec,GI+Random,20,20501490,1.7529042871811218
23547,3131419,ls,jfreechart,GI,1,3154966,0.7466666477335524
10652,4846891,ls,jfreechart,GI,2,4857543,1.1496052090677311
10485,5431598,ls,jfreechart,GI,3,5442083,1.2879447418126706
10342,4152332,ls,jfreechart,GI,4,4162674,0.985154781759175
10459,5341448,ls,jfreechart,GI,5,5351907,1.2666033353994095
10184,3610445,ls,jfreechart,GI,6,3620629,0.8568722826543563
10069,3466736,ls,jfreechart,GI,7,3476805,0.8228343298068042
10973,5275572,ls,jfreechart,GI,8,5286545,1.2511345077070792
10005,4331665,ls,jfreechart,GI,9,4341670,1.0275166782986989
10135,38388908,ls,jfreechart,GI,10,38399043,9.08766836567701
10085,4153018,ls,jfreechart,GI,11,4163103,0.9852563105844865
10813,4481553,ls,jfreechart,GI,12,4492366,1.0631809856626626
10415,3733558,ls,jfreechart,GI,13,3743973,0.886063358246945
9984,5084503,ls,jfreechart,GI,14,5094487,1.2056813069339454
9991,3727841,ls,jfreechart,GI,15,3737832,0.8846100050622414
10351,4193234,ls,jfreechart,GI,16,4203585,0.9948369397366073
10319,4236898,ls,jfreechart,GI,17,4247217,1.0051630602633927
10623,4975559,ls,jfreechart,GI,18,4986182,1.1800494201615421
10557,3256346,ls,jfreechart,GI,19,3266903,0.7731580978941407
11190,4119706,ls,jfreechart,GI,20,4130896,0.9776340754404138
13840,1882970,ls,jfreechart,GI+Ekstazi,1,1896810,0.44890650615172384
14787,1676703,ls,jfreechart,GI+Ekstazi,2,1691490,0.4003146683592871
13100,1148077,ls,jfreechart,GI+Ekstazi,3,1161177,0.2748087104632199
13333,1626603,ls,jfreechart,GI+Ekstazi,4,1639936,0.38811369619120173
13755,1721595,ls,jfreechart,GI+Ekstazi,5,1735350,0.4106947482617626
13560,1721412,ls,jfreechart,GI+Ekstazi,6,1734972,0.41060528929680284
13619,1577574,ls,jfreechart,GI+Ekstazi,7,1591193,0.37657798632603157
13650,1390772,ls,jfreechart,GI+Ekstazi,8,1404422,0.33237602774269237
13260,1726021,ls,jfreechart,GI+Ekstazi,9,1739281,0.41162507416455857
12834,1812451,ls,jfreechart,GI+Ekstazi,10,1825285,0.43197911866826366
12532,1448527,ls,jfreechart,GI+Ekstazi,11,1461059,0.3457799626591654
13377,2164901,ls,jfreechart,GI+Ekstazi,12,2178278,0.5155198287689144
12984,1590678,ls,jfreechart,GI+Ekstazi,13,1603662,0.37952894885006183
12905,1822948,ls,jfreechart,GI+Ekstazi,14,1835853,0.43448018306428193
13470,1253725,ls,jfreechart,GI+Ekstazi,15,1267195,0.2998993468312238
13250,1313332,ls,jfreechart,GI+Ekstazi,16,1326582,0.31395410755097564
13195,1727713,ls,jfreechart,GI+Ekstazi,17,1740908,0.4120101263761712
13226,1364098,ls,jfreechart,GI+Ekstazi,18,1377324,0.3259629086091474
13357,1549673,ls,jfreechart,GI+Ekstazi,19,1563030,0.3699128201086713
12201,1613232,ls,jfreechart,GI+Ekstazi,20,1625433,0.3846813592366736
43023,2138119,ls,jfreechart,GI+STARTS,1,2181142,0.5161976342600383
25758,2160938,ls,jfreechart,GI+STARTS,2,2186696,0.517512065718733
30554,1614193,ls,jfreechart,GI+STARTS,3,1644747,0.3892522863510469
26624,2027916,ls,jfreechart,GI+STARTS,4,2054540,0.48623550758851053
25849,2126115,ls,jfreechart,GI+STARTS,5,2151964,0.5092922541552861
26228,1436222,ls,jfreechart,GI+STARTS,6,1462450,0.3461091621836602
25593,2302714,ls,jfreechart,GI+STARTS,7,2328307,0.5510262812925921
29382,1778450,ls,jfreechart,GI+STARTS,8,1807832,0.4278486231247638
25144,2220169,ls,jfreechart,GI+STARTS,9,2245313,0.5313845952135667
24641,1988523,ls,jfreechart,GI+STARTS,10,2013164,0.4764433008843421
26681,1494552,ls,jfreechart,GI+STARTS,11,1521233,0.36002097789061915
25718,1936799,ls,jfreechart,GI+STARTS,12,1962517,0.46445698289937454
28125,1969774,ls,jfreechart,GI+STARTS,13,1997899,0.47283062601632364
24985,1768782,ls,jfreechart,GI+STARTS,14,1793767,0.42451994497090334
25099,1868840,ls,jfreechart,GI+STARTS,15,1893939,0.44822704401310076
24930,1433626,ls,jfreechart,GI+STARTS,16,1458556,0.3451875928462174
26237,1656399,ls,jfreechart,GI+STARTS,17,1682636,0.39821924593665786
30196,1475680,ls,jfreechart,GI+STARTS,18,1505876,0.3563865299411819
25363,1704582,ls,jfreechart,GI+STARTS,19,1729945,0.4094155797284092
25544,1593654,ls,jfreechart,GI+STARTS,20,1619198,0.38320575964269427
9912,1142363,ls,jfreechart,GI+Random,1,1152275,0.2727019281720244
9497,1328674,ls,jfreechart,GI+Random,2,1338171,0.3166968058179567
9604,1248876,ls,jfreechart,GI+Random,3,1258480,0.2978368206946512
9777,1572361,ls,jfreechart,GI+Random,4,1582138,0.3744349944537808
9551,1294432,ls,jfreechart,GI+Random,5,1303983,0.30860573943159475
9189,2752225,ls,jfreechart,GI+Random,6,2761414,0.6535270853582891
9537,989349,ls,jfreechart,GI+Random,7,998886,0.2364002848487043
10063,921743,ls,jfreechart,GI+Random,8,931806,0.22052486852727113
9838,1058321,ls,jfreechart,GI+Random,9,1068159,0.25279470516526126
9653,3083200,ls,jfreechart,GI+Random,10,3092853,0.731966741144805
9197,3991713,ls,jfreechart,GI+Random,11,4000910,0.9468710780349605
9708,1199986,ls,jfreechart,GI+Random,12,1209694,0.286290934280557
9988,1167618,ls,jfreechart,GI+Random,13,1177606,0.27869686214397166
9476,1650537,ls,jfreechart,GI+Random,14,1660013,0.39286519788299384
11194,1137653,ls,jfreechart,GI+Random,15,1148847,0.27189064422524634
9681,1792186,ls,jfreechart,GI+Random,16,1801867,0.42643692279147
9904,3657551,ls,jfreechart,GI+Random,17,3667455,0.8679543077686591
9888,3085820,ls,jfreechart,GI+Random,18,3095708,0.7326424166605726
9806,1752417,ls,jfreechart,GI+Random,19,1762223,0.4170546180114029
9422,1321640,ls,jfreechart,GI+Random,20,1331062,0.3150143619504989
22978,3129882,ls,joda-time,GI,1,3152860,2.0630626356746395
9894,1777588,ls,joda-time,GI,2,1787482,1.1696324372604479
9294,1061401,ls,joda-time,GI,3,1070695,0.7006054340197972
9303,829231,ls,joda-time,GI,4,838534,0.5486917161379821
24441,1126160,ls,joda-time,GI,5,1150601,0.752891638597932
412343,948136,ls,joda-time,GI,6,1360479,0.8902245553307149
17153,1429477,ls,joda-time,GI,7,1446630,0.9465971532659248
26171,3492405,ls,joda-time,GI,8,3518576,2.3023675889134085
13561,2579894,ls,joda-time,GI,9,2593455,1.697017979803598
15045,1100564,ls,joda-time,GI,10,1115609,0.7299947488700256
9137,3923854,ls,joda-time,GI,11,3932991,2.5735385581803936
14531,1085921,ls,joda-time,GI,12,1100452,0.7200768202690345
9720,3236688,ls,joda-time,GI,13,3246408,2.124275434036156
10444,1124513,ls,joda-time,GI,14,1134957,0.74265504329319465
9137,2594897,ls,joda-time,GI,15,2604034,1.703940310520091
9274,955237,ls,joda-time,GI,16,964511,0.6311243143676478
9870,3247723,ls,joda-time,GI,17,3257593,2.1315942986796923
10306,1509696,ls,joda-time,GI,18,1520002,0.994607858373262
9538,3059318,ls,joda-time,GI,19,3068856,2.008094919490853
9546,1526937,ls,joda-time,GI,20,1536483,1.005392141626738
12480,655788,ls,joda-time,GI+Ekstazi,1,668268,0.4372787695670026
11029,329072,ls,joda-time,GI+Ekstazi,2,340101,0.22254386983741128
11397,691713,ls,joda-time,GI+Ekstazi,3,703110,0.46007750733276953
10726,1155830,ls,joda-time,GI+Ekstazi,4,1166556,0.7633317356375052
11259,675793,ls,joda-time,GI+Ekstazi,5,687052,0.44957001261252716
11168,540536,ls,joda-time,GI+Ekstazi,6,551704,0.36100553413479863
11658,843323,ls,joda-time,GI+Ekstazi,7,854981,0.5594537516133729
11463,782456,ls,joda-time,GI+Ekstazi,8,793919,0.5194980508656185
11083,1114351,ls,joda-time,GI+Ekstazi,9,1125434,0.7364237023901639
11124,965568,ls,joda-time,GI+Ekstazi,10,976692,0.6390949080397909
11506,1264238,ls,joda-time,GI+Ekstazi,11,1275744,0.834778511918102
11051,631683,ls,joda-time,GI+Ekstazi,12,642734,0.4205706882251999
11072,1323113,ls,joda-time,GI+Ekstazi,13,1334185,0.8730191707140719
10876,1183727,ls,joda-time,GI+Ekstazi,14,1194603,0.781684189518352
10757,671632,ls,joda-time,GI+Ekstazi,15,682389,0.4465187952828167
10720,643218,ls,joda-time,GI+Ekstazi,16,653938,0.4279019854506075
10667,543559,ls,joda-time,GI+Ekstazi,17,554226,0.36265579579157103
11026,1160060,ls,joda-time,GI+Ekstazi,18,1171086,0.7662959248941186
11124,514875,ls,joda-time,GI+Ekstazi,19,525999,0.3441855595561568
10744,656112,ls,joda-time,GI+Ekstazi,20,666856,0.4363548324300626
9442,907067,ls,joda-time,GI+Random,1,916509,0.599714377790174
9085,453722,ls,joda-time,GI+Random,2,462807,0.3028361009460213
8866,1264817,ls,joda-time,GI+Random,3,1273683,0.8334299039583051
9559,815665,ls,joda-time,GI+Random,4,825224,0.5399823653641356
9255,2235874,ls,joda-time,GI+Random,5,2245129,1.46909211070887
8904,919743,ls,joda-time,GI+Random,6,928647,0.6076568345665037
9432,2636473,ls,joda-time,GI+Random,7,2645905,1.7313384492317154
9737,608352,ls,joda-time,GI+Random,8,618089,0.40444432084567733
8797,1929898,ls,joda-time,GI+Random,9,1938695,1.268578121600466
9005,2425225,ls,joda-time,GI+Random,10,2434230,1.5928296719925013
9154,3093224,ls,joda-time,GI+Random,11,3102378,2.030029919989792
8914,881881,ls,joda-time,GI+Random,12,890795,0.5828885140938038
8725,2610905,ls,joda-time,GI+Random,13,2619630,1.7141454971969436
8829,2390264,ls,joda-time,GI+Random,14,2399093,1.5698379020345266
8718,917687,ls,joda-time,GI+Random,15,926405,0.606189789905725
8707,839164,ls,joda-time,GI+Random,16,847871,0.5548013486079598
9382,1996510,ls,joda-time,GI+Random,17,2005892,1.3125482375997264
8952,2732652,ls,joda-time,GI+Random,18,2741604,1.7939587467303129
9068,2617915,ls,joda-time,GI+Random,19,2626983,1.7189569063810226
8580,2225945,ls,joda-time,GI+Random,20,2234525,1.4621534213320202
22996,1992010,ls,spatial4j,GI,1,2015006,0.6424949007101222
10946,1828284,ls,spatial4j,GI,2,1839230,0.5864478300476912
12396,3038102,ls,spatial4j,GI,3,3050498,0.9726667859184669
10916,2081694,ls,spatial4j,GI,4,2092610,0.6672393303915763
13242,3613200,ls,spatial4j,GI,5,3626442,1.1563094565083265
13257,4214713,ls,spatial4j,GI,6,4227970,1.3481097154824229
10756,2578875,ls,spatial4j,GI,7,2589631,0.8257170014485586
9387,3195823,ls,spatial4j,GI,8,3205210,1.0219974931613556
9022,3386959,ls,spatial4j,GI,9,3395981,1.0828257957586536
9049,1893084,ls,spatial4j,GI,10,1902133,0.6065047711879998
8801,3019741,ls,spatial4j,GI,11,3028542,0.9656660037669539
9776,6544545,ls,spatial4j,GI,12,6554321,2.0898785512883182
9301,3886891,ls,spatial4j,GI,13,3896192,1.24232061452302
10696,3056536,ls,spatial4j,GI,14,3067232,0.9780025068386443
9511,3995581,ls,spatial4j,GI,15,4005092,1.277043932809582
11425,3641340,ls,spatial4j,GI,16,3652765,1.1647026787971893
11061,2302839,ls,spatial4j,GI,17,2313900,0.73779877119629
10020,3436510,ls,spatial4j,GI,18,3446530,1.0989436012321836
9671,2673644,ls,spatial4j,GI,19,2683315,0.8555886208274226
11135,4010846,ls,spatial4j,GI,20,4021981,1.2824290762672657
12783,1999677,ls,spatial4j,GI+Ekstazi,1,2012460,0.64168309567469894
12343,1681653,ls,spatial4j,GI+Ekstazi,2,1693996,0.5401392312595318
10999,1168806,ls,spatial4j,GI+Ekstazi,3,1179805,0.3761868184671935
11558,1873847,ls,spatial4j,GI+Ekstazi,4,1885405,0.6011709633983064
12507,1660568,ls,spatial4j,GI+Ekstazi,5,1673075,0.5334684641165275
15396,1607718,ls,spatial4j,GI+Ekstazi,6,1623114,0.51753814543044
12087,1582092,ls,spatial4j,GI+Ekstazi,7,1594179,0.5083120736708286
12904,1321571,ls,spatial4j,GI+Ekstazi,8,1334475,0.42550413379669355
12467,4879080,ls,spatial4j,GI+Ekstazi,9,4891547,1.5596946133579235
13280,1712024,ls,spatial4j,GI+Ekstazi,10,1725304,0.5501219461256078
14306,1961620,ls,spatial4j,GI+Ekstazi,11,1975926,0.6300340441569647
13132,1847573,ls,spatial4j,GI+Ekstazi,12,1860705,0.5932952429053947
12226,1400009,ls,spatial4j,GI+Ekstazi,13,1412235,0.4502983048707346
11440,4917022,ls,spatial4j,GI+Ekstazi,14,4928462,1.5714651486613986
12523,1753480,ls,spatial4j,GI+Ekstazi,15,1766003,0.5630990290543938
11214,1464818,ls,spatial4j,GI+Ekstazi,16,1476032,0.47064030245317534
10779,1545619,ls,spatial4j,GI+Ekstazi,17,1556398,0.49626540986748063
11950,1707350,ls,spatial4j,GI+Ekstazi,18,1719300,0.548207540221177
14394,2150118,ls,spatial4j,GI+Ekstazi,19,2164512,0.6901656484029665
14986,1832340,ls,spatial4j,GI+Ekstazi,20,1847326,0.5890292807809143
23015,3582500,ls,spatial4j,GI+STARTS,1,3605515,1.149636776234838
19449,3241957,ls,spatial4j,GI+STARTS,2,3261406,1.039915873275512
20827,2553358,ls,spatial4j,GI+STARTS,3,2574185,0.820791965872303
22345,2217065,ls,spatial4j,GI+STARTS,4,2239410,0.714047256236088
18452,3114241,ls,spatial4j,GI+STARTS,5,3132693,0.9988750792753445
18522,2354349,ls,spatial4j,GI+STARTS,6,2372871,0.7566019741593466
19226,4091990,ls,spatial4j,GI+STARTS,7,4111216,1.3108821093921634
17731,1862375,ls,spatial4j,GI+STARTS,8,1880106,0.5994813503257583
19896,3513876,ls,spatial4j,GI+STARTS,9,3533772,1.1267611561812767
18630,2159254,ls,spatial4j,GI+STARTS,10,2177884,0.6944293785418821
29862,2014427,ls,spatial4j,GI+STARTS,11,2044289,0.6518319340378117
19213,3309688,ls,spatial4j,GI+STARTS,12,3328901,1.0614369969463249
25283,5439526,ls,spatial4j,GI+STARTS,13,5464809,1.7424821146213867
19174,3185591,ls,spatial4j,GI+STARTS,14,3204765,1.021855602650451
18659,2547368,ls,spatial4j,GI+STARTS,15,2566027,0.8181907461240774
18660,2542924,ls,spatial4j,GI+STARTS,16,2561584,0.8167740730005953
19138,5115463,ls,spatial4j,GI+STARTS,17,5134601,1.6371936161386587
21083,2117267,ls,spatial4j,GI+STARTS,18,2138350,0.6818237617820938
18426,2490564,ls,spatial4j,GI+STARTS,19,2508990,0.800004208887065
20386,1893145,ls,spatial4j,GI+STARTS,20,1913531,0.6101390813976438
10247,1462666,ls,spatial4j,GI+Random,1,1472913,0.4696457934565198
9400,1560122,ls,spatial4j,GI+Random,2,1569522,0.5004500639463865
10103,1256874,ls,spatial4j,GI+Random,3,1266977,0.40398205356063877
8943,1385575,ls,spatial4j,GI+Random,4,1394518,0.444649149406244
9489,1294911,ls,spatial4j,GI+Random,5,1304400,0.4159145672451017
9741,1508031,ls,spatial4j,GI+Random,6,1517772,0.48394931352095405
9029,1407676,ls,spatial4j,GI+Random,7,1416705,0.4517235870813951
9551,1076265,ls,spatial4j,GI+Random,8,1085816,0.3462179482887207
10547,1243626,ls,spatial4j,GI+Random,9,1254173,0.39989943310755205
11610,1173935,ls,spatial4j,GI+Random,10,1185545,0.37801704663032354
11309,1635394,ls,spatial4j,GI+Random,11,1646703,0.525059617928711
9594,1713012,ls,spatial4j,GI+Random,12,1722606,0.5492616751179206
9267,1132117,ls,spatial4j,GI+Random,13,1141384,0.36393608741220723
11757,1334541,ls,spatial4j,GI+Random,14,1346298,0.42927395741562857
9821,1416130,ls,spatial4j,GI+Random,15,1425951,0.4546717211574057
9169,1488187,ls,spatial4j,GI+Random,16,1497356,0.47743956819369554
10404,1310902,ls,spatial4j,GI+Random,17,1321306,0.4213051312391569
10855,1672130,ls,spatial4j,GI+Random,18,1682985,0.5366283179661128
9693,1721714,ls,spatial4j,GI+Random,19,1731407,0.5520679186830265
10529,1394432,ls,spatial4j,GI+Random,20,1404961,0.44797895301383417
